CustomerID,first_date,last_date,T,frequency,recency,Sales,avg_freq,sleeping
12346,2011-01-18,2011-01-18,325,0,0,77183.6,0.0,325
12347,2010-12-07,2011-12-07,367,6,365,4309.999999999997,61.0,2
12348,2010-12-16,2011-09-25,358,3,283,1797.24,94.0,75
12349,2011-11-21,2011-11-21,18,0,0,1757.55,0.0,18
12350,2011-02-02,2011-02-02,310,0,0,334.40000000000003,0.0,310
12352,2011-02-16,2011-11-03,296,6,260,2506.040000000001,43.0,36
12353,2011-05-19,2011-05-19,204,0,0,89.0,0.0,204
12354,2011-04-21,2011-04-21,232,0,0,1079.4,0.0,232
12355,2011-05-09,2011-05-09,214,0,0,459.4,0.0,214
12356,2011-01-18,2011-11-17,325,2,303,2811.430000000001,152.0,22
12357,2011-11-06,2011-11-06,33,0,0,6207.669999999996,0.0,33
12358,2011-07-12,2011-12-08,150,1,149,1168.06,149.0,1
12359,2011-01-12,2011-10-13,331,3,274,6372.580000000005,91.0,57
12360,2011-05-23,2011-10-18,200,2,148,2662.0600000000004,74.0,52
12361,2011-02-25,2011-02-25,287,0,0,189.90000000000003,0.0,287
12362,2011-02-17,2011-12-06,295,9,292,5226.230000000003,32.0,3
12363,2011-04-11,2011-08-22,242,1,133,552.0,133.0,109
12364,2011-08-19,2011-12-02,112,3,105,1313.1000000000001,35.0,7
12365,2011-02-21,2011-02-21,291,0,0,641.38,0.0,291
12367,2011-12-05,2011-12-05,4,0,0,168.9,0.0,4
12370,2010-12-14,2011-10-19,360,3,309,3545.689999999998,103.0,51
12371,2011-10-11,2011-10-26,59,1,15,1887.9600000000003,15.0,44
12372,2011-02-16,2011-09-29,296,2,225,1298.0400000000002,112.0,71
12373,2011-02-01,2011-02-01,311,0,0,364.6,0.0,311
12374,2011-11-14,2011-11-14,25,0,0,742.93,0.0,25
12375,2011-09-02,2011-11-29,98,1,88,457.5000000000001,88.0,10
12377,2010-12-20,2011-01-28,354,1,39,1628.12,39.0,315
12378,2011-08-02,2011-08-02,129,0,0,4008.6200000000013,0.0,129
12379,2011-06-22,2011-09-19,170,1,89,852.2399999999997,89.0,81
12380,2011-06-07,2011-11-18,185,3,164,2724.81,55.0,21
12381,2011-08-12,2011-12-05,119,4,115,1845.3100000000006,29.0,4
12383,2010-12-22,2011-06-08,352,4,168,1850.5599999999997,42.0,184
12384,2011-08-10,2011-11-11,121,1,93,585.2700000000001,93.0,28
12386,2010-12-08,2011-01-06,366,1,29,401.90000000000003,29.0,337
12388,2011-01-17,2011-11-24,326,5,311,2780.6600000000003,62.0,15
12390,2011-09-21,2011-09-21,79,0,0,549.84,0.0,79
12391,2011-11-18,2011-11-18,21,0,0,460.88999999999993,0.0,21
12393,2011-01-11,2011-09-28,332,3,260,1582.6000000000004,87.0,72
12394,2011-05-06,2011-10-07,217,1,154,1272.48,154.0,63
12395,2010-12-03,2011-11-20,371,10,352,3018.6299999999987,35.0,19
12397,2011-07-27,2011-11-04,135,1,100,2409.9000000000005,100.0,35
12398,2011-10-25,2011-10-25,45,0,0,1635.6599999999999,0.0,45
12399,2011-03-23,2011-08-12,261,3,142,1108.65,47.0,119
12401,2011-02-09,2011-02-09,303,0,0,84.3,0.0,303
12402,2011-01-20,2011-01-20,323,0,0,225.60000000000002,0.0,323
12403,2011-10-21,2011-10-21,49,0,0,427.7,0.0,49
12405,2011-07-14,2011-07-14,148,0,0,1710.3900000000006,0.0,148
12406,2011-06-09,2011-11-17,183,1,161,3415.300000000001,161.0,22
12407,2011-03-20,2011-10-21,264,4,215,1708.1199999999997,54.0,49
12408,2011-03-24,2011-11-07,260,3,228,2888.5500000000006,76.0,32
12409,2011-06-10,2011-09-22,182,2,104,11072.670000000002,52.0,78
12410,2011-02-04,2011-02-04,308,0,0,693.3299999999999,0.0,308
12412,2011-06-23,2011-09-26,169,2,95,1226.8799999999999,48.0,74
12413,2011-01-06,2011-10-04,337,2,271,758.0999999999999,136.0,66
12414,2011-02-02,2011-05-06,310,2,93,562.41,46.0,217
12415,2011-01-06,2011-11-15,337,15,313,124914.52999999975,21.0,24
12417,2010-12-17,2011-12-06,357,8,354,3649.1,44.0,3
12418,2011-08-19,2011-08-19,112,0,0,668.5799999999998,0.0,112
12420,2011-10-07,2011-10-07,63,0,0,600.3900000000001,0.0,63
12421,2011-01-24,2011-11-24,319,3,304,807.0400000000002,101.0,15
12422,2011-01-19,2011-09-05,324,2,229,803.5599999999998,114.0,95
12423,2010-12-21,2011-12-09,353,7,353,1859.3100000000002,50.0,0
12424,2011-06-30,2011-06-30,162,0,0,1760.9599999999996,0.0,162
12425,2011-09-22,2011-09-22,78,0,0,777.1999999999999,0.0,78
12426,2011-05-29,2011-05-29,194,0,0,582.73,0.0,194
12427,2010-12-03,2011-11-18,371,2,350,825.8000000000002,175.0,21
12428,2011-03-01,2011-11-14,283,6,258,7956.460000000004,43.0,25
12429,2010-12-09,2011-11-30,365,3,356,3750.400000000001,119.0,9
12430,2011-10-27,2011-10-27,43,0,0,256.4,0.0,43
12431,2010-12-01,2011-11-04,373,13,338,6487.449999999999,26.0,35
12432,2011-06-20,2011-10-28,172,2,130,5059.3200000000015,65.0,42
12433,2010-12-01,2011-12-09,373,5,373,13375.869999999992,75.0,0
12434,2011-03-24,2011-09-16,260,1,176,806.14,176.0,84
12435,2011-03-17,2011-09-21,267,1,188,7829.8899999999985,188.0,79
12436,2011-09-01,2011-09-01,99,0,0,509.01,0.0,99
12437,2011-01-12,2011-12-08,331,14,330,4951.409999999997,24.0,1
12438,2011-07-22,2011-11-25,140,1,126,2906.8500000000004,126.0,14
12441,2010-12-08,2010-12-08,366,0,0,173.55,0.0,366
12442,2011-12-06,2011-12-06,3,0,0,172.06,0.0,3
12444,2011-06-21,2011-11-18,171,4,150,5005.46,38.0,21
12445,2011-11-17,2011-11-17,22,0,0,133.4,0.0,22
12446,2011-10-13,2011-10-13,57,0,0,1002.3099999999998,0.0,57
12447,2011-04-10,2011-04-10,243,0,0,476.49,0.0,243
12448,2011-10-26,2011-10-26,44,0,0,449.4500000000001,0.0,44
12449,2011-06-05,2011-11-17,187,3,165,4067.2900000000013,55.0,22
12450,2011-06-19,2011-07-06,173,1,17,197.88,17.0,156
12451,2011-01-19,2011-11-29,324,4,314,9035.519999999999,78.0,10
12452,2011-11-23,2011-11-23,16,0,0,430.5700000000001,0.0,16
12453,2011-07-28,2011-07-28,134,0,0,707.0899999999999,0.0,134
12454,2011-10-14,2011-10-14,56,0,0,3528.34,0.0,56
12455,2011-02-16,2011-09-27,296,5,223,2466.859999999997,45.0,73
12456,2011-03-30,2011-10-26,254,2,210,3181.039999999998,105.0,44
12457,2011-04-14,2011-10-04,239,6,173,2363.2299999999996,29.0,66
12458,2011-02-28,2011-09-29,284,1,213,947.4000000000002,213.0,71
12461,2011-07-08,2011-09-06,154,1,60,826.8800000000002,60.0,94
12462,2011-02-09,2011-11-21,303,1,285,1189.5900000000001,285.0,18
12463,2011-04-12,2011-10-17,241,3,188,1344.7799999999997,63.0,53
12464,2011-02-03,2011-11-29,309,6,299,1212.05,50.0,10
12465,2011-06-23,2011-11-22,169,1,152,742.1900000000002,152.0,17
12468,2011-01-27,2011-06-05,316,1,129,729.5400000000001,129.0,187
12471,2010-12-10,2011-12-07,364,19,362,19824.049999999945,19.0,2
12472,2010-12-05,2011-11-07,369,6,337,6572.110000000003,56.0,32
12473,2011-06-01,2011-11-10,191,3,162,3938.55,54.0,29
12474,2011-01-14,2011-11-22,329,16,312,7375.789999999998,20.0,17
12475,2011-10-17,2011-10-17,53,0,0,723.38,0.0,53
12476,2010-12-13,2011-11-24,361,9,346,6816.420000000005,38.0,15
12477,2011-02-11,2011-11-17,301,5,279,13219.73999999999,56.0,22
12478,2011-12-06,2011-12-06,3,0,0,680.9900000000002,0.0,3
12479,2011-11-28,2011-11-28,11,0,0,527.2,0.0,11
12480,2011-01-07,2011-11-11,336,3,308,3281.6300000000015,103.0,28
12481,2010-12-09,2011-11-17,365,7,343,5596.320000000002,49.0,22
12483,2011-01-04,2011-11-22,339,7,322,2484.980000000001,46.0,17
12484,2011-01-07,2011-11-07,336,5,304,4541.720000000001,61.0,32
12488,2011-09-25,2011-11-30,75,2,66,1298.6599999999999,33.0,9
12489,2011-01-07,2011-01-07,336,0,0,334.93,0.0,336
12490,2011-01-14,2011-12-04,329,9,324,5417.9299999999985,36.0,5
12491,2011-11-01,2011-11-01,38,0,0,460.40000000000003,0.0,38
12492,2011-08-26,2011-10-07,105,1,42,263.21000000000004,42.0,63
12493,2011-05-26,2011-06-27,197,1,32,433.74,32.0,165
12494,2010-12-09,2011-11-24,365,6,350,1246.1000000000006,58.0,15
12497,2011-09-19,2011-09-19,81,0,0,1043.1,0.0,81
12498,2011-10-13,2011-11-18,57,1,36,403.70000000000005,36.0,21
12500,2011-01-10,2011-11-16,333,9,310,4257.820000000001,34.0,23
12501,2011-01-07,2011-01-07,336,0,0,2169.3899999999994,0.0,336
12502,2011-02-03,2011-09-05,309,4,214,3723.87,54.0,95
12504,2011-11-09,2011-11-21,30,1,12,482.04999999999995,12.0,18
12506,2011-04-21,2011-04-21,232,0,0,73.50000000000003,0.0,232
12507,2011-02-14,2011-07-28,298,2,164,1304.8100000000002,82.0,134
12508,2011-11-10,2011-11-13,29,1,3,398.27000000000004,3.0,26
12509,2011-02-28,2011-02-28,284,0,0,176.5,0.0,284
12510,2011-01-18,2011-07-20,325,1,183,982.57,183.0,142
12512,2011-10-04,2011-10-04,66,0,0,138.03000000000006,0.0,66
12513,2011-08-19,2011-08-19,112,0,0,612.2900000000001,0.0,112
12514,2011-03-17,2011-03-17,267,0,0,1017.6800000000002,0.0,267
12515,2010-12-21,2010-12-21,353,0,0,383.7,0.0,353
12516,2011-06-12,2011-09-23,180,1,103,1312.06,103.0,77
12517,2011-06-02,2011-11-11,190,3,162,2502.8399999999983,54.0,28
12518,2011-08-21,2011-12-09,110,4,110,2056.8899999999994,28.0,0
12519,2011-10-07,2011-10-07,63,0,0,340.84000000000003,0.0,63
12520,2011-03-11,2011-09-21,273,4,194,2634.26,48.0,79
12521,2011-07-20,2011-07-20,142,0,0,599.6800000000001,0.0,142
12522,2011-10-19,2011-10-31,51,1,12,192.72000000000003,12.0,39
12523,2011-01-12,2011-11-20,331,10,312,1789.7700000000007,31.0,19
12524,2011-01-10,2011-11-30,333,7,324,4485.719999999999,46.0,9
12526,2011-09-06,2011-12-09,94,2,94,1316.6600000000005,47.0,0
12527,2011-01-18,2011-09-19,325,2,244,348.71000000000004,122.0,81
12528,2011-01-31,2011-11-30,312,5,303,1933.4800000000007,61.0,9
12530,2011-01-07,2011-10-11,336,3,277,1662.2799999999993,92.0,59
12531,2011-11-25,2011-11-25,14,0,0,125.22,0.0,14
12532,2011-11-09,2011-11-09,30,0,0,349.83,0.0,30
12534,2011-08-01,2011-08-01,130,0,0,1089.18,0.0,130
12535,2011-06-06,2011-09-09,186,1,95,716.3500000000001,95.0,91
12536,2011-10-11,2011-10-27,59,1,16,12601.830000000005,16.0,43
12538,2011-11-10,2011-11-10,29,0,0,363.95,0.0,29
12539,2011-01-10,2011-11-17,333,3,311,5568.349999999995,104.0,22
12540,2010-12-13,2011-11-20,361,16,342,13400.23999999999,21.0,19
12541,2011-03-04,2011-11-10,280,2,251,981.1800000000002,126.0,29
12544,2011-11-03,2011-11-03,36,0,0,372.70000000000005,0.0,36
12545,2011-03-25,2011-09-25,259,1,184,1000.3899999999999,184.0,75
12546,2011-09-23,2011-10-24,77,1,31,1161.5,31.0,46
12547,2011-03-04,2011-05-26,280,1,83,207.8,83.0,197
12548,2011-06-26,2011-06-26,166,0,0,95.19999999999999,0.0,166
12550,2011-09-21,2011-09-21,79,0,0,964.8299999999994,0.0,79
12551,2010-12-17,2010-12-17,357,0,0,168.0,0.0,357
12552,2011-10-31,2011-11-01,39,1,1,437.81999999999994,1.0,38
12553,2011-01-14,2011-12-01,329,9,321,3692.280000000001,36.0,8
12556,2011-07-11,2011-10-20,151,1,101,603.7099999999997,101.0,50
12557,2010-12-03,2011-11-23,371,4,355,11990.96,89.0,16
12558,2011-12-02,2011-12-02,7,0,0,269.96000000000004,0.0,7
12559,2011-01-24,2011-02-02,319,1,9,561.71,9.0,310
12560,2011-07-19,2011-12-04,143,2,138,2134.01,69.0,5
12561,2011-02-10,2011-02-10,302,0,0,238.85000000000002,0.0,302
12562,2011-05-25,2011-12-01,198,6,190,3781.7400000000025,32.0,8
12564,2011-03-23,2011-03-23,261,0,0,456.9000000000001,0.0,261
12565,2011-02-24,2011-02-24,288,0,0,145.92000000000002,0.0,288
12566,2011-09-14,2011-09-14,86,0,0,351.65000000000003,0.0,86
12567,2010-12-05,2011-11-17,369,8,347,9401.279999999993,43.0,22
12569,2011-04-01,2011-12-07,252,25,250,4124.69,10.0,2
12571,2011-08-10,2011-10-31,121,1,82,519.6099999999999,82.0,39
12572,2011-10-19,2011-12-01,51,1,43,1020.4200000000003,43.0,8
12573,2011-04-26,2011-04-26,227,0,0,160.54000000000002,0.0,227
12574,2011-01-28,2011-01-28,315,0,0,218.45000000000002,0.0,315
12576,2011-02-08,2011-11-04,304,4,269,1315.8299999999997,67.0,35
12577,2010-12-15,2011-11-04,359,1,324,657.8000000000003,324.0,35
12578,2011-01-13,2011-11-18,330,1,309,2794.5099999999993,309.0,21
12579,2011-09-22,2011-09-22,78,0,0,440.41999999999996,0.0,78
12580,2011-04-07,2011-04-07,246,0,0,415.7,0.0,246
12581,2011-10-31,2011-10-31,39,0,0,197.70999999999998,0.0,39
12582,2011-02-24,2011-04-15,288,1,50,511.3599999999999,50.0,238
12583,2010-12-01,2011-12-07,373,14,371,7281.379999999993,26.0,2
12584,2011-03-04,2011-12-06,280,8,277,2338.1499999999996,35.0,3
12585,2010-12-23,2011-04-19,351,1,117,2040.099999999999,117.0,234
12586,2011-11-22,2011-11-22,17,0,0,196.94,0.0,17
12587,2011-12-02,2011-12-02,7,0,0,144.0,0.0,7
12588,2011-10-31,2011-10-31,39,0,0,214.9,0.0,39
12589,2011-07-18,2011-11-11,144,1,116,646.6800000000001,116.0,28
12590,2011-05-12,2011-05-12,211,0,0,9864.260000000004,0.0,211
12591,2011-01-26,2011-01-26,317,0,0,452.8499999999999,0.0,317
12592,2011-05-10,2011-09-08,213,1,121,437.59999999999997,121.0,92
12593,2011-05-05,2011-08-23,218,2,110,418.1,55.0,108
12594,2011-01-21,2011-11-02,322,8,285,3338.2199999999984,36.0,37
12596,2011-04-11,2011-10-19,242,1,191,618.27,191.0,51
12597,2011-03-16,2011-11-20,268,3,249,3811.2200000000016,83.0,19
12598,2011-02-28,2011-11-30,284,6,275,3023.079999999999,46.0,9
12599,2011-02-08,2011-11-10,304,6,275,1032.5800000000006,46.0,29
12600,2010-12-03,2011-11-11,371,9,343,2599.0400000000004,38.0,28
12601,2011-01-11,2011-06-03,332,4,143,577.0600000000001,36.0,189
12602,2011-10-12,2011-10-12,58,0,0,153.12000000000003,0.0,58
12603,2011-11-18,2011-11-18,21,0,0,739.1999999999998,0.0,21
12604,2011-03-23,2011-09-21,261,1,182,254.17999999999995,182.0,79
12607,2011-10-10,2011-10-10,60,0,0,1579.51,0.0,60
12609,2011-01-25,2011-09-22,318,2,240,1126.8500000000001,120.0,78
12610,2011-08-05,2011-11-17,126,4,104,2099.540000000001,26.0,22
12611,2011-10-18,2011-10-18,52,0,0,1193.32,0.0,52
12612,2011-09-26,2011-09-26,74,0,0,704.04,0.0,74
12613,2011-03-22,2011-10-13,262,2,205,3344.3799999999983,102.0,57
12614,2011-03-07,2011-03-07,277,0,0,315.59999999999997,0.0,277
12615,2011-06-24,2011-12-07,168,3,166,2291.1900000000005,55.0,2
12616,2011-02-15,2011-09-05,297,1,202,713.3,202.0,95
12617,2011-11-10,2011-11-10,29,0,0,355.5300000000002,0.0,29
12618,2011-11-18,2011-11-18,21,0,0,177.31,0.0,21
12619,2011-03-31,2011-11-23,253,8,237,3641.2400000000002,30.0,16
12620,2011-05-19,2011-11-25,204,2,190,1339.4099999999999,95.0,14
12621,2010-12-09,2011-12-08,365,16,364,13689.67,23.0,1
12622,2011-04-21,2011-04-21,232,0,0,180.10000000000002,0.0,232
12623,2011-03-08,2011-03-08,276,0,0,305.1,0.0,276
12624,2011-06-15,2011-08-25,177,1,71,641.1300000000001,71.0,106
12625,2011-01-24,2011-05-12,319,1,108,2683.8199999999997,108.0,211
12626,2011-01-17,2011-11-16,326,8,303,6620.479999999998,38.0,23
12627,2011-07-22,2011-11-29,140,6,130,4478.53,22.0,10
12628,2011-10-06,2011-12-05,64,2,60,786.4599999999998,30.0,4
12630,2011-10-27,2011-11-30,43,1,34,1270.8799999999999,34.0,9
12631,2011-10-13,2011-10-13,57,0,0,640.5000000000002,0.0,57
12633,2011-02-25,2011-10-12,287,3,229,2163.9799999999996,76.0,58
12635,2011-07-08,2011-09-11,154,1,65,1689.1800000000003,65.0,89
12637,2011-01-20,2011-10-03,323,6,256,6021.900000000001,43.0,67
12638,2011-11-06,2011-11-06,33,0,0,671.69,0.0,33
12639,2011-04-15,2011-04-15,238,0,0,486.1000000000001,0.0,238
12640,2011-09-19,2011-11-16,81,2,58,1174.58,29.0,23
12641,2011-08-16,2011-08-16,115,0,0,185.9,0.0,115
12642,2011-08-24,2011-11-14,107,2,82,1013.26,41.0,25
12643,2011-01-11,2011-08-03,332,4,204,3344.64,51.0,128
12644,2011-08-02,2011-08-02,129,0,0,477.9100000000001,0.0,129
12645,2011-01-27,2011-11-06,316,3,283,1775.1800000000007,94.0,33
12646,2011-10-21,2011-12-05,49,1,45,1346.9700000000003,45.0,4
12647,2010-12-05,2011-11-17,369,10,347,3722.820000000001,35.0,22
12648,2011-07-08,2011-07-08,154,0,0,318.05,0.0,154
12649,2011-05-11,2011-08-24,212,1,105,623.5099999999999,105.0,107
12650,2011-12-06,2011-12-06,3,0,0,314.43999999999994,0.0,3
12651,2011-01-09,2011-01-09,334,0,0,114.0,0.0,334
12652,2011-01-12,2011-01-12,331,0,0,919.9799999999998,0.0,331
12653,2011-02-16,2011-07-14,296,1,148,2209.8500000000004,148.0,148
12654,2011-02-17,2011-11-29,295,3,285,601.98,95.0,10
12656,2011-04-20,2011-11-22,233,4,216,4051.1700000000023,54.0,17
12657,2011-09-22,2011-11-28,78,2,67,1643.1800000000003,34.0,11
12658,2011-11-21,2011-11-21,18,0,0,686.0500000000001,0.0,18
12659,2011-11-10,2011-11-10,29,0,0,91.67999999999999,0.0,29
12660,2011-11-28,2011-11-28,11,0,0,245.10000000000005,0.0,11
12662,2010-12-01,2011-12-09,373,9,373,3849.7799999999984,41.0,0
12664,2011-01-21,2011-12-01,322,8,314,4881.879999999999,39.0,8
12665,2011-01-19,2011-01-19,324,0,0,63.0,0.0,324
12667,2011-10-12,2011-10-12,58,0,0,620.13,0.0,58
12668,2010-12-19,2011-11-28,355,3,344,3807.150000000002,115.0,11
12669,2011-03-28,2011-07-12,256,2,106,2744.0300000000007,53.0,150
12670,2011-04-21,2011-11-29,232,4,222,2996.0500000000006,56.0,10
12672,2011-01-14,2011-01-14,329,0,0,225.9,0.0,329
12673,2011-01-17,2011-12-04,326,1,321,610.52,321.0,5
12674,2011-05-16,2011-11-01,207,3,169,1970.6000000000004,56.0,38
12676,2011-02-01,2011-11-15,311,5,287,1331.3900000000006,57.0,24
12678,2010-12-21,2011-10-28,353,8,311,17628.460000000003,39.0,42
12679,2011-03-01,2011-10-12,283,3,225,1113.0200000000002,75.0,58
12680,2011-08-18,2011-12-09,113,3,113,862.81,38.0,0
12681,2010-12-07,2011-11-25,367,19,353,13787.54,19.0,14
12682,2010-12-03,2011-12-06,371,26,368,12288.219999999998,14.0,3
12683,2010-12-09,2011-12-05,365,10,361,8476.569999999998,36.0,4
12684,2011-05-10,2011-12-02,213,6,206,2283.6299999999997,34.0,7
12685,2011-09-07,2011-11-11,93,5,65,2863.0800000000004,13.0,28
12686,2010-12-03,2010-12-03,371,0,0,89.14,0.0,371
12688,2011-08-18,2011-08-18,113,0,0,4873.810000000005,0.0,113
12689,2011-08-04,2011-11-14,127,1,102,1247.61,102.0,25
12690,2011-05-18,2011-05-18,205,0,0,389.01,0.0,205
12691,2010-12-17,2011-11-11,357,5,329,1035.8,66.0,28
12693,2011-01-24,2011-08-04,319,3,192,855.9099999999999,64.0,127
12694,2011-06-09,2011-09-30,183,1,113,869.6699999999998,113.0,70
12695,2011-05-13,2011-12-02,210,3,203,582.1,68.0,7
12697,2011-06-23,2011-11-11,169,2,141,957.5899999999999,70.0,28
12700,2011-05-08,2011-12-02,215,3,208,4939.990000000006,69.0,7
12701,2011-04-11,2011-09-21,242,1,163,797.71,163.0,79
12702,2011-11-20,2011-11-20,19,0,0,219.00000000000003,0.0,19
12703,2011-09-29,2011-09-29,71,0,0,283.55,0.0,71
12704,2011-06-23,2011-12-02,169,6,162,2340.84,27.0,7
12705,2010-12-17,2011-11-24,357,7,342,6868.290000000003,49.0,15
12707,2011-02-21,2011-02-21,291,0,0,603.42,0.0,291
12708,2010-12-06,2011-11-10,368,9,339,2712.9100000000008,38.0,29
12709,2010-12-08,2011-11-24,366,14,351,9736.519999999991,25.0,15
12710,2011-05-22,2011-09-04,201,2,105,1149.0200000000007,52.0,96
12712,2010-12-03,2011-11-11,371,12,343,4396.129999999999,29.0,28
12713,2011-12-09,2011-12-09,0,0,0,848.5499999999998,0.0,0
12714,2011-02-18,2011-11-30,294,4,285,4708.859999999994,71.0,9
12715,2011-08-25,2011-08-25,106,0,0,353.86,0.0,106
12716,2011-07-29,2011-12-06,133,1,130,1053.4899999999996,130.0,3
12717,2011-04-08,2011-07-11,245,1,94,1030.98,94.0,151
12718,2011-09-29,2011-09-29,71,0,0,238.25000000000006,0.0,71
12719,2011-10-05,2011-12-04,65,1,60,644.95,60.0,5
12720,2010-12-05,2011-12-07,369,20,367,5781.730000000001,18.0,2
12721,2010-12-20,2011-11-08,354,5,323,2656.130000000001,65.0,31
12722,2011-07-12,2011-09-15,150,3,65,997.6299999999999,22.0,85
12723,2011-10-05,2011-12-06,65,2,62,725.0699999999998,31.0,3
12724,2011-01-11,2011-12-04,332,3,327,1031.4099999999999,109.0,5
12725,2010-12-03,2010-12-03,371,0,0,427.79999999999995,0.0,371
12726,2010-12-17,2011-11-11,357,6,329,2609.1000000000004,55.0,28
12727,2011-01-23,2011-11-29,320,5,310,3980.7000000000003,62.0,10
12728,2011-01-11,2011-09-29,332,3,261,836.3299999999999,87.0,71
12729,2011-08-18,2011-08-18,113,0,0,453.0100000000001,0.0,113
12731,2010-12-10,2011-11-16,364,10,341,18895.910000000007,34.0,23
12732,2011-06-13,2011-06-13,179,0,0,236.2600000000001,0.0,179
12733,2011-04-19,2011-04-19,234,0,0,383.95000000000005,0.0,234
12734,2010-12-22,2010-12-22,352,0,0,110.39999999999999,0.0,352
12735,2011-01-06,2011-01-28,337,1,22,779.5699999999998,22.0,315
12736,2011-01-11,2011-01-11,332,0,0,234.00000000000003,0.0,332
12738,2010-12-02,2010-12-02,372,0,0,155.35,0.0,372
12739,2011-09-01,2011-09-22,99,1,21,1013.0399999999997,21.0,78
12740,2011-10-07,2011-10-07,63,0,0,427.59999999999997,0.0,63
12743,2011-07-28,2011-07-28,134,0,0,546.4299999999997,0.0,134
12744,2011-01-25,2011-10-19,318,5,267,21279.289999999994,53.0,51
12747,2010-12-05,2011-12-07,369,10,367,4196.010000000001,37.0,2
12748,2010-12-01,2011-12-09,373,112,373,33719.730000000316,3.0,0
12749,2011-05-10,2011-12-06,213,3,210,4090.880000000001,70.0,3
12750,2011-08-03,2011-08-03,128,0,0,275.88,0.0,128
12752,2011-09-19,2011-09-19,81,0,0,4366.779999999999,0.0,81
12753,2010-12-12,2011-11-17,362,5,340,21429.39,68.0,22
12754,2011-02-04,2011-04-18,308,2,73,3010.7400000000007,36.0,235
12755,2010-12-09,2011-03-04,365,1,85,3811.95,85.0,280
12756,2011-09-14,2011-09-14,86,0,0,112.08000000000001,0.0,86
12757,2011-05-12,2011-11-24,211,8,196,7857.099999999999,24.0,15
12758,2011-03-08,2011-08-15,276,1,160,2791.590000000001,160.0,116
12759,2011-03-09,2011-10-18,275,2,223,1531.4400000000007,112.0,52
12762,2011-11-14,2011-12-02,25,1,18,1898.5200000000004,18.0,7
12763,2010-12-05,2011-07-24,369,1,231,494.08,231.0,138
12764,2011-01-27,2011-01-27,316,0,0,1693.8800000000006,0.0,316
12766,2010-12-08,2011-12-06,366,6,363,6989.629999999999,60.0,3
12769,2011-04-15,2011-04-15,238,0,0,1143.6000000000001,0.0,238
12770,2011-05-13,2011-05-13,210,0,0,1351.4499999999998,0.0,210
12772,2011-10-11,2011-10-11,59,0,0,892.4700000000004,0.0,59
12775,2011-02-01,2011-11-22,311,4,294,1386.0400000000004,74.0,17
12778,2011-01-31,2011-11-20,312,5,293,822.2300000000001,59.0,19
12779,2010-12-03,2011-11-02,371,7,334,3981.360000000003,48.0,37
12781,2011-02-28,2011-10-07,284,1,221,826.7400000000001,221.0,63
12782,2010-12-17,2011-12-05,357,4,353,2330.9200000000014,88.0,4
12783,2011-09-25,2011-12-07,75,4,73,2225.91,18.0,2
12784,2011-11-24,2011-11-30,15,1,6,574.42,6.0,9
12785,2010-12-10,2010-12-10,364,0,0,311.95000000000005,0.0,364
12787,2011-05-31,2011-11-30,192,2,183,463.66,92.0,9
12789,2011-10-05,2011-10-05,65,0,0,91.85000000000001,0.0,65
12790,2011-05-31,2011-05-31,192,0,0,324.9200000000001,0.0,192
12791,2010-12-01,2010-12-01,373,0,0,192.60000000000005,0.0,373
12792,2011-03-28,2011-03-28,256,0,0,400.54,0.0,256
12793,2010-12-03,2011-01-09,371,1,37,545.48,37.0,334
12794,2011-09-02,2011-10-17,98,1,45,860.4099999999999,45.0,53
12795,2011-11-21,2011-11-21,18,0,0,430.4800000000001,0.0,18
12797,2010-12-09,2010-12-09,365,0,0,254.03,0.0,365
12798,2011-06-22,2011-11-29,170,2,160,6977.039999999999,80.0,10
12802,2011-06-06,2011-06-06,186,0,0,427.58,0.0,186
12808,2010-12-06,2011-11-03,368,2,332,483.65000000000015,166.0,36
12809,2011-06-15,2011-06-15,177,0,0,489.31,0.0,177
12811,2011-02-28,2011-03-24,284,2,24,514.85,12.0,260
12812,2011-10-26,2011-10-26,44,0,0,229.64,0.0,44
12814,2011-08-30,2011-08-30,101,0,0,125.92,0.0,101
12815,2011-05-25,2011-07-15,198,1,51,1063.46,51.0,147
12816,2011-06-16,2011-09-05,176,1,81,572.2,81.0,95
12817,2011-03-03,2011-03-03,281,0,0,166.04000000000002,0.0,281
12818,2011-03-23,2011-03-23,261,0,0,1542.0800000000002,0.0,261
12820,2011-01-17,2011-12-06,326,3,323,942.3399999999999,108.0,3
12821,2011-05-09,2011-05-09,214,0,0,92.72,0.0,214
12822,2011-09-13,2011-09-30,87,1,17,948.8799999999999,17.0,70
12823,2011-02-16,2011-09-26,296,4,222,1759.5,56.0,74
12824,2011-10-11,2011-10-11,59,0,0,397.11999999999995,0.0,59
12826,2010-12-09,2011-12-07,365,6,363,1474.7199999999993,60.0,2
12827,2011-10-26,2011-12-04,44,2,39,430.15,20.0,5
12828,2011-08-01,2011-12-07,130,5,128,1018.7100000000003,26.0,2
12829,2010-12-14,2011-01-07,360,1,24,293.0,24.0,336
12830,2011-06-21,2011-11-02,171,4,134,6814.640000000001,34.0,37
12831,2011-03-22,2011-03-22,262,0,0,215.05,0.0,262
12832,2011-09-02,2011-11-07,98,1,66,383.03000000000003,66.0,32
12833,2011-07-17,2011-07-17,145,0,0,417.37999999999994,0.0,145
12834,2011-03-02,2011-03-02,282,0,0,312.38000000000005,0.0,282
12836,2011-02-01,2011-10-11,311,3,252,2612.8599999999988,84.0,59
12837,2011-06-19,2011-06-19,173,0,0,134.1,0.0,173
12838,2010-12-01,2011-11-06,373,1,340,683.1299999999995,340.0,33
12839,2010-12-07,2011-12-07,367,13,365,5591.420000000003,28.0,2
12840,2011-04-27,2011-07-19,226,3,83,2726.769999999999,28.0,143
12841,2010-12-03,2011-12-05,371,23,367,4022.3499999999967,16.0,4
12842,2011-02-04,2011-09-30,308,1,238,1118.99,238.0,70
12843,2011-03-20,2011-10-05,264,7,199,1702.26,28.0,65
12844,2011-08-01,2011-11-10,130,1,101,325.9599999999999,101.0,29
12845,2011-02-22,2011-03-17,290,3,23,354.09000000000003,8.0,267
12847,2011-11-17,2011-11-17,22,0,0,871.5399999999998,0.0,22
12849,2011-03-16,2011-11-08,268,1,237,1050.8899999999999,237.0,31
12851,2011-09-04,2011-09-04,96,0,0,135.17999999999995,0.0,96
12852,2011-02-18,2011-02-18,294,0,0,311.55,0.0,294
12853,2011-01-28,2011-07-28,315,2,181,1957.1,90.0,134
12854,2011-01-25,2011-09-22,318,2,240,1324.5000000000007,120.0,78
12855,2010-12-02,2010-12-02,372,0,0,38.10000000000001,0.0,372
12856,2011-10-07,2011-12-02,63,5,56,2179.9300000000007,11.0,7
12857,2011-02-10,2011-05-13,302,1,92,1106.4000000000003,92.0,210
12863,2011-10-18,2011-10-18,52,0,0,521.2,0.0,52
12864,2011-07-24,2011-07-24,138,0,0,147.12,0.0,138
12865,2011-08-08,2011-11-13,123,1,97,1568.229999999999,97.0,26
12866,2011-03-01,2011-03-01,283,0,0,559.12,0.0,283
12867,2010-12-14,2011-11-13,360,6,334,4036.819999999996,56.0,26
12868,2010-12-01,2011-06-07,373,5,188,1607.0600000000009,38.0,185
12871,2011-05-16,2011-09-16,207,1,123,380.64000000000004,123.0,84
12872,2010-12-09,2011-01-17,365,1,39,599.9699999999998,39.0,326
12873,2011-03-02,2011-03-02,282,0,0,374.0,0.0,282
12875,2010-12-12,2011-07-19,362,1,219,343.23000000000013,219.0,143
12876,2011-05-27,2011-10-13,196,1,139,2218.0200000000004,139.0,57
12877,2010-12-16,2011-12-06,358,11,355,1535.7700000000007,32.0,3
12878,2011-03-18,2011-04-17,266,1,30,854.9899999999999,30.0,236
12879,2011-09-09,2011-10-26,91,2,47,573.22,24.0,44
12881,2011-03-09,2011-03-09,275,0,0,298.0,0.0,275
12882,2011-11-06,2011-11-30,33,1,24,1463.0399999999997,24.0,9
12883,2011-09-11,2011-11-15,89,1,65,703.4700000000001,65.0,24
12884,2011-09-12,2011-09-12,88,0,0,309.05000000000007,0.0,88
12885,2011-08-08,2011-10-07,123,1,60,1175.2199999999998,60.0,63
12886,2011-05-04,2011-10-03,219,1,152,1378.4,152.0,67
12888,2011-03-29,2011-05-09,255,1,41,354.12,41.0,214
12890,2011-11-15,2011-11-15,24,0,0,380.4699999999999,0.0,24
12891,2011-02-20,2011-06-07,292,2,107,331.0,54.0,185
12893,2011-11-09,2011-11-09,30,0,0,188.14,0.0,30
12895,2011-09-14,2011-10-28,86,1,44,372.79999999999995,44.0,42
12897,2011-02-11,2011-05-19,301,1,97,216.50000000000003,97.0,204
12901,2011-03-14,2011-12-01,270,22,262,17654.539999999997,12.0,8
12902,2011-03-20,2011-03-20,264,0,0,138.68,0.0,264
12904,2011-06-20,2011-11-21,172,1,154,509.57999999999976,154.0,18
12906,2011-09-22,2011-11-28,78,1,67,2919.809999999999,67.0,11
12908,2011-01-31,2011-06-16,312,1,136,750.0,136.0,176
12909,2011-03-31,2011-10-31,253,3,214,2178.67,71.0,39
12910,2011-04-12,2011-11-16,241,5,218,3075.040000000002,44.0,23
12912,2011-10-30,2011-12-07,40,4,38,1662.3,10.0,2
12913,2010-12-06,2011-12-05,368,4,364,2483.6299999999997,91.0,4
12915,2010-12-02,2011-07-14,372,1,224,363.65,224.0,148
12916,2011-01-23,2011-07-24,320,3,182,3006.1500000000005,61.0,138
12917,2011-08-03,2011-08-03,128,0,0,594.0,0.0,128
12919,2011-06-23,2011-12-01,169,5,161,1335.1899999999998,32.0,8
12920,2011-11-22,2011-11-22,17,0,0,164.23000000000002,0.0,17
12921,2010-12-01,2011-11-30,373,22,364,16587.09000000002,17.0,9
12922,2011-07-01,2011-07-01,161,0,0,405.38,0.0,161
12923,2011-10-06,2011-10-06,64,0,0,176.97,0.0,64
12924,2011-01-16,2011-09-12,327,3,239,933.7000000000003,80.0,88
12925,2011-09-26,2011-12-05,74,1,70,694.0499999999998,70.0,4
12928,2010-12-15,2011-11-04,359,4,324,2062.6999999999994,81.0,35
12929,2011-02-01,2011-02-01,311,0,0,117.85000000000001,0.0,311
12930,2011-06-21,2011-09-22,171,1,93,415.80000000000007,93.0,78
12931,2010-12-17,2011-11-18,357,11,336,42055.95999999999,31.0,21
12933,2011-03-01,2011-11-15,283,2,259,607.5299999999999,130.0,24
12935,2011-01-24,2011-12-07,319,5,317,2160.6999999999994,63.0,2
12936,2011-09-22,2011-11-22,78,2,61,1063.9000000000005,30.0,17
12937,2011-03-17,2011-11-24,267,3,252,1504.2700000000004,84.0,15
12938,2011-11-14,2011-11-14,25,0,0,114.13999999999999,0.0,25
12939,2011-01-09,2011-10-06,334,5,270,11581.8,54.0,64
12940,2011-09-13,2011-10-16,87,1,33,913.5400000000001,33.0,54
12942,2010-12-09,2011-07-31,365,2,234,683.9000000000001,117.0,131
12944,2010-12-20,2011-11-04,354,1,319,604.51,319.0,35
12945,2011-02-24,2011-02-24,288,0,0,462.95000000000005,0.0,288
12947,2010-12-01,2011-07-19,373,5,230,1603.9900000000002,46.0,143
12948,2011-03-20,2011-11-23,264,6,248,2064.95,41.0,16
12949,2011-04-01,2011-11-09,252,4,222,4167.220000000001,56.0,30
12950,2011-11-15,2011-12-07,24,2,22,1843.0,11.0,2
12951,2011-01-13,2011-12-01,330,5,322,1064.0700000000004,64.0,8
12952,2011-09-22,2011-12-04,78,2,73,1387.7900000000004,36.0,5
12953,2011-11-30,2011-11-30,9,0,0,329.85,0.0,9
12955,2011-03-17,2011-12-08,267,10,266,4757.159999999999,27.0,1
12956,2011-02-06,2011-02-06,306,0,0,108.07,0.0,306
12957,2011-01-04,2011-11-30,339,6,330,4017.5400000000027,55.0,9
12962,2011-08-18,2011-12-02,113,1,106,266.39000000000004,106.0,7
12963,2010-12-09,2011-12-01,365,6,357,1856.6299999999997,60.0,8
12965,2011-09-11,2011-09-11,89,0,0,771.9099999999996,0.0,89
12966,2011-11-30,2011-11-30,9,0,0,160.18000000000004,0.0,9
12967,2010-12-03,2010-12-16,371,1,13,1660.9,13.0,358
12968,2011-08-19,2011-08-19,112,0,0,135.95,0.0,112
12970,2011-01-21,2011-12-02,322,1,315,452.2399999999999,315.0,7
12971,2010-12-02,2011-12-06,372,70,369,11189.909999999996,5.0,3
12974,2011-05-26,2011-05-26,197,0,0,144.8,0.0,197
12976,2011-05-12,2011-05-12,211,0,0,738.6,0.0,211
12977,2011-07-06,2011-07-06,156,0,0,39.24,0.0,156
12980,2010-12-16,2011-07-05,358,8,201,7374.900000000001,25.0,157
12981,2011-07-29,2011-11-10,133,1,104,372.22,104.0,29
12982,2011-04-11,2011-04-11,242,0,0,390.53999999999996,0.0,242
12984,2011-11-21,2011-11-21,18,0,0,97.5,0.0,18
12985,2011-11-11,2011-12-09,28,1,28,1239.38,28.0,0
12987,2011-05-26,2011-09-27,197,1,124,558.7,124.0,73
12988,2011-02-20,2011-02-20,292,0,0,535.32,0.0,292
12989,2010-12-10,2011-12-06,364,12,361,6924.109999999996,30.0,3
12990,2011-02-02,2011-11-08,310,2,279,409.50000000000006,140.0,31
12991,2011-08-19,2011-11-16,112,1,89,503.76,89.0,23
12993,2011-02-14,2011-11-16,298,3,275,414.76,92.0,23
12994,2011-03-16,2011-12-05,268,2,264,974.42,132.0,4
12995,2011-09-15,2011-09-15,85,0,0,211.32,0.0,85
12997,2011-01-26,2011-11-17,317,3,295,1226.89,98.0,22
12999,2011-04-08,2011-05-27,245,2,49,455.8799999999999,24.0,196
13000,2010-12-10,2011-08-25,364,2,258,534.8500000000001,129.0,106
13001,2011-01-17,2011-12-05,326,12,322,9818.820000000012,27.0,4
13002,2011-01-25,2011-01-25,318,0,0,120.95,0.0,318
13003,2011-05-09,2011-08-26,214,2,109,149.05,54.0,105
13004,2010-12-17,2011-11-28,357,16,346,5655.91,22.0,11
13005,2011-04-07,2011-06-19,246,1,73,513.7,73.0,173
13006,2011-10-14,2011-10-14,56,0,0,81.57,0.0,56
13008,2011-01-20,2011-01-20,323,0,0,229.47000000000003,0.0,323
13011,2010-12-02,2010-12-02,372,0,0,50.550000000000004,0.0,372
13012,2011-02-18,2011-11-30,294,7,285,1661.8400000000008,41.0,9
13013,2010-12-03,2011-12-08,371,11,370,4810.9400000000005,34.0,1
13014,2011-03-03,2011-11-29,281,9,271,3466.2799999999993,30.0,10
13015,2011-04-04,2011-10-17,249,3,196,3346.2800000000016,65.0,53
13016,2011-08-08,2011-09-27,123,1,50,789.8899999999996,50.0,73
13017,2011-12-02,2011-12-02,7,0,0,204.0,0.0,7
13018,2011-02-17,2011-11-23,295,19,279,7277.699999999997,15.0,16
13021,2010-12-16,2011-12-05,358,7,354,2616.38,51.0,4
13023,2011-08-02,2011-10-06,129,1,65,689.9,65.0,64
13026,2011-03-09,2011-12-08,275,4,274,975.3599999999998,68.0,1
13027,2010-12-20,2011-08-18,354,5,241,6912.0,48.0,113
13028,2011-10-25,2011-11-17,45,1,23,661.32,23.0,22
13029,2010-12-21,2011-11-09,353,2,323,1247.5,162.0,30
13030,2010-12-06,2011-11-28,368,1,357,799.4800000000001,357.0,11
13032,2011-09-13,2011-10-18,87,1,35,1010.1799999999997,35.0,52
13033,2010-12-17,2010-12-17,357,0,0,190.55,0.0,357
13034,2010-12-05,2011-10-16,369,1,315,642.77,315.0,54
13035,2011-03-24,2011-09-27,260,1,187,921.8800000000002,187.0,73
13037,2011-03-28,2011-07-24,256,2,118,881.0700000000002,59.0,138
13038,2011-02-22,2011-09-20,290,2,210,908.4600000000002,105.0,80
13040,2011-11-06,2011-12-01,33,1,25,676.9900000000001,25.0,8
13043,2011-03-11,2011-03-11,273,0,0,516.4200000000001,0.0,273
13044,2011-02-21,2011-02-21,291,0,0,560.4700000000001,0.0,291
13045,2011-09-01,2011-09-01,99,0,0,305.28,0.0,99
13046,2011-03-18,2011-11-09,266,1,236,629.31,236.0,30
13047,2010-12-01,2011-11-08,373,7,342,3237.540000000001,49.0,31
13048,2011-01-16,2011-11-25,327,3,313,1835.9099999999996,104.0,14
13049,2011-01-25,2011-10-06,318,1,254,656.6800000000002,254.0,64
13050,2010-12-08,2011-11-25,366,16,352,5836.860000000001,22.0,14
13052,2011-05-11,2011-05-11,212,0,0,348.15000000000003,0.0,212
13055,2011-05-10,2011-09-22,213,1,135,1214.41,135.0,78
13058,2011-07-11,2011-11-15,151,2,127,271.4,64.0,24
13059,2011-04-04,2011-04-04,249,0,0,183.4,0.0,249
13060,2011-03-31,2011-03-31,253,0,0,307.53000000000003,0.0,253
13061,2011-09-28,2011-09-28,72,0,0,248.60999999999999,0.0,72
13062,2011-06-01,2011-06-01,191,0,0,346.98,0.0,191
13064,2011-01-16,2011-11-27,327,3,315,1119.4900000000005,105.0,12
13065,2010-12-01,2010-12-01,373,0,0,205.86,0.0,373
13066,2011-11-07,2011-11-15,32,1,8,470.80000000000007,8.0,24
13067,2011-09-18,2011-09-18,82,0,0,115.46000000000002,0.0,82
13068,2011-01-24,2011-11-29,319,1,309,344.0,309.0,10
13069,2010-12-05,2011-12-09,369,19,369,4436.119999999994,19.0,0
13070,2011-05-31,2011-05-31,192,0,0,228.8,0.0,192
13072,2011-03-18,2011-03-18,266,0,0,177.15000000000006,0.0,266
13075,2011-08-02,2011-08-02,129,0,0,919.6100000000001,0.0,129
13077,2010-12-08,2011-12-08,366,2,365,729.2700000000001,182.0,1
13078,2010-12-08,2011-12-06,366,24,363,12627.94,15.0,3
13079,2011-07-22,2011-12-05,140,4,136,220.10000000000002,34.0,4
13080,2011-06-13,2011-06-13,179,0,0,58.08,0.0,179
13081,2010-12-03,2011-11-28,371,8,360,28337.38000000005,45.0,11
13082,2011-01-05,2011-08-05,338,6,212,3613.6300000000006,35.0,126
13083,2011-09-25,2011-12-05,75,1,71,303.75,71.0,4
13085,2011-02-17,2011-07-05,295,1,138,416.08000000000004,138.0,157
13089,2010-12-05,2011-12-07,369,65,367,58825.83000000013,6.0,2
13090,2010-12-02,2011-12-01,372,12,364,8910.82,30.0,8
13091,2011-11-11,2011-11-11,28,0,0,345.82,0.0,28
13092,2010-12-15,2011-09-30,359,4,289,477.83000000000004,72.0,70
13093,2010-12-01,2011-03-09,373,6,98,7832.469999999998,16.0,275
13094,2010-12-06,2011-11-18,368,11,347,1927.3200000000002,32.0,21
13095,2011-09-30,2011-09-30,70,0,0,74.4,0.0,70
13097,2010-12-14,2011-11-07,360,8,328,6010.419999999994,41.0,32
13098,2011-01-26,2011-12-08,317,25,316,28882.440000000013,13.0,1
13099,2011-09-01,2011-09-01,99,0,0,207.36,0.0,99
13101,2011-04-19,2011-04-19,234,0,0,101.18999999999998,0.0,234
13102,2010-12-09,2011-12-08,365,19,364,6424.090000000001,19.0,1
13103,2011-10-31,2011-10-31,39,0,0,243.94,0.0,39
13104,2010-12-20,2011-12-06,354,5,351,1098.48,70.0,3
13106,2011-07-29,2011-07-29,133,0,0,76.5,0.0,133
13107,2011-01-10,2011-10-26,333,3,289,1531.6200000000003,96.0,44
13108,2010-12-02,2010-12-02,372,0,0,350.05999999999995,0.0,372
13109,2011-07-05,2011-10-11,157,1,98,786.5400000000001,98.0,59
13110,2011-02-01,2011-11-08,311,5,280,1488.6700000000012,56.0,31
13113,2010-12-08,2011-12-09,366,22,366,12245.960000000003,17.0,0
13115,2011-06-08,2011-11-28,184,3,173,2294.7800000000007,58.0,11
13116,2011-07-24,2011-07-24,138,0,0,501.14000000000004,0.0,138
13117,2010-12-02,2011-11-18,372,7,351,984.9099999999996,50.0,21
13118,2011-02-24,2011-11-20,288,3,269,1197.8099999999995,90.0,19
13120,2011-04-15,2011-04-15,238,0,0,30.6,0.0,238
13121,2011-03-15,2011-03-15,269,0,0,283.7299999999999,0.0,269
13122,2011-04-13,2011-09-06,240,1,146,922.3900000000003,146.0,94
13124,2010-12-15,2011-09-11,359,2,270,3866.3299999999977,135.0,89
13126,2010-12-08,2011-12-05,366,6,362,2099.6399999999994,60.0,4
13127,2011-09-23,2011-09-23,77,0,0,259.16999999999996,0.0,77
13130,2011-09-06,2011-09-06,94,0,0,64.0,0.0,94
13131,2011-06-05,2011-11-16,187,2,164,1073.2999999999997,82.0,23
13132,2011-03-23,2011-03-23,261,0,0,77.3,0.0,261
13133,2011-02-08,2011-03-11,304,1,31,109.79999999999998,31.0,273
13134,2011-04-13,2011-09-15,240,3,155,1793.58,52.0,85
13135,2011-05-27,2011-05-27,196,0,0,3096.0,0.0,196
13136,2011-05-11,2011-10-14,212,3,156,2607.6099999999997,52.0,56
13137,2011-02-04,2011-11-29,308,7,298,3650.409999999999,43.0,10
13138,2010-12-02,2011-11-17,372,5,350,962.3900000000001,70.0,22
13139,2011-03-25,2011-11-23,259,5,243,5064.940000000003,49.0,16
13140,2010-12-08,2011-08-23,366,2,258,423.71999999999997,129.0,108
13141,2011-01-28,2011-09-16,315,3,231,2388.7499999999995,77.0,84
13142,2011-11-20,2011-11-20,19,0,0,307.0899999999999,0.0,19
13144,2011-01-11,2011-01-11,332,0,0,110.94999999999999,0.0,332
13145,2010-12-02,2011-10-31,372,3,333,618.52,111.0,39
13146,2011-11-13,2011-11-13,26,0,0,228.91,0.0,26
13147,2011-09-01,2011-11-29,99,3,89,712.8,30.0,10
13148,2010-12-10,2011-11-10,364,6,335,3707.120000000001,56.0,29
13149,2011-02-23,2011-11-25,289,3,275,1676.0599999999997,92.0,14
13151,2011-02-17,2011-02-17,295,0,0,1257.8700000000003,0.0,295
13153,2011-12-04,2011-12-04,5,0,0,486.22,0.0,5
13155,2010-12-06,2011-11-06,368,3,335,971.76,112.0,33
13157,2011-02-14,2011-10-21,298,3,249,1741.2199999999991,83.0,49
13158,2011-01-25,2011-09-06,318,3,224,1201.0600000000004,75.0,94
13159,2011-08-16,2011-12-01,115,3,107,1437.8500000000006,36.0,8
13160,2011-11-17,2011-11-17,22,0,0,91.80000000000001,0.0,22
13161,2011-01-30,2011-01-30,313,0,0,112.75,0.0,313
13162,2011-01-09,2011-08-09,334,3,212,1688.2899999999995,71.0,122
13165,2010-12-23,2011-10-24,351,1,305,1021.4799999999999,305.0,46
13166,2011-03-01,2011-03-01,283,0,0,417.19999999999993,0.0,283
13167,2011-07-19,2011-11-21,143,3,125,791.3300000000002,42.0,18
13168,2011-01-25,2011-11-03,318,3,282,1319.19,94.0,36
13169,2011-04-01,2011-10-07,252,1,189,712.88,189.0,63
13170,2011-11-13,2011-11-13,26,0,0,116.01000000000002,0.0,26
13171,2011-02-13,2011-11-18,299,2,278,468.4099999999999,139.0,21
13173,2010-12-07,2011-12-05,367,1,363,353.65000000000003,363.0,4
13174,2010-12-05,2011-11-23,369,2,353,2817.0300000000007,176.0,16
13176,2011-10-24,2011-10-24,46,0,0,492.8400000000001,0.0,46
13177,2011-10-06,2011-10-06,64,0,0,282.45,0.0,64
13178,2010-12-14,2011-11-13,360,10,334,5725.470000000003,33.0,26
13182,2011-10-25,2011-10-25,45,0,0,121.17999999999999,0.0,45
13183,2011-01-09,2011-12-02,334,8,327,3957.780000000002,41.0,7
13184,2011-02-22,2011-11-25,290,8,276,1701.2900000000009,34.0,14
13185,2011-03-17,2011-03-17,267,0,0,71.4,0.0,267
13186,2011-08-03,2011-10-31,128,2,89,1575.8900000000006,44.0,39
13187,2011-01-06,2011-01-06,337,0,0,236.01999999999995,0.0,337
13188,2011-11-28,2011-11-28,11,0,0,114.6,0.0,11
13189,2011-08-16,2011-11-21,115,1,97,260.68,97.0,18
13192,2011-05-18,2011-09-05,205,1,110,911.9400000000002,110.0,95
13193,2011-10-09,2011-10-09,61,0,0,117.88000000000001,0.0,61
13194,2011-07-27,2011-07-27,135,0,0,60.7,0.0,135
13196,2011-03-22,2011-11-28,262,2,251,1797.78,126.0,11
13198,2010-12-13,2011-11-29,361,5,351,3401.239999999997,70.0,10
13199,2010-12-08,2011-12-06,366,32,363,9817.120000000003,11.0,3
13200,2011-08-05,2011-11-20,126,3,107,870.09,36.0,19
13203,2011-04-11,2011-11-30,242,3,233,869.4599999999999,78.0,9
13207,2011-07-12,2011-11-24,150,1,135,250.26000000000005,135.0,15
13208,2011-02-03,2011-10-12,309,5,251,1223.8999999999999,50.0,58
13209,2010-12-13,2011-11-09,361,5,331,5891.609999999999,66.0,30
13210,2011-09-07,2011-09-07,93,0,0,353.47999999999996,0.0,93
13211,2010-12-13,2011-11-29,361,2,351,1197.4199999999998,176.0,10
13212,2011-10-09,2011-11-20,61,1,42,788.0799999999998,42.0,19
13213,2011-05-24,2011-10-14,199,3,143,1520.5800000000004,48.0,56
13216,2011-03-17,2011-03-17,267,0,0,333.74,0.0,267
13217,2011-07-06,2011-08-09,156,2,34,533.98,17.0,122
13218,2011-08-04,2011-08-04,127,0,0,62.64,0.0,127
13220,2011-04-17,2011-09-22,236,3,158,819.29,53.0,78
13221,2010-12-15,2011-04-13,359,1,119,847.4100000000001,119.0,240
13223,2011-04-21,2011-05-23,232,1,32,163.20000000000002,32.0,200
13224,2011-07-11,2011-10-10,151,1,91,2155.95,91.0,60
13225,2010-12-13,2011-12-06,361,6,358,6463.840000000002,60.0,3
13226,2011-03-11,2011-03-11,273,0,0,108.21000000000001,0.0,273
13227,2011-05-22,2011-05-22,201,0,0,257.7,0.0,201
13228,2011-09-19,2011-09-19,81,0,0,358.0,0.0,81
13229,2011-04-28,2011-04-28,225,0,0,160.95,0.0,225
13230,2010-12-09,2011-12-05,365,12,361,2806.9700000000007,30.0,4
13232,2011-04-10,2011-11-27,243,6,231,1357.6000000000015,38.0,12
13233,2011-01-07,2011-09-26,336,1,262,605.1200000000001,262.0,74
13235,2011-05-11,2011-05-11,212,0,0,1031.0699999999997,0.0,212
13236,2011-08-25,2011-11-15,106,1,82,744.8500000000003,82.0,24
13238,2010-12-14,2011-11-22,360,3,343,700.7300000000001,114.0,17
13239,2011-03-23,2011-03-23,261,0,0,329.56,0.0,261
13240,2010-12-09,2011-09-04,365,3,269,663.6500000000001,90.0,96
13242,2011-05-10,2011-08-19,213,1,101,270.40000000000003,101.0,112
13243,2011-05-20,2011-05-20,203,0,0,600.07,0.0,203
13244,2011-09-08,2011-09-08,92,0,0,121.74000000000001,0.0,92
13245,2011-10-20,2011-10-20,50,0,0,430.5,0.0,50
13246,2011-01-13,2011-11-21,330,5,312,1987.3000000000009,62.0,18
13247,2011-09-18,2011-11-22,82,3,65,501.12,22.0,17
13248,2011-06-03,2011-08-07,189,1,65,465.6799999999999,65.0,124
13249,2011-03-23,2011-09-08,261,2,169,711.41,84.0,92
13253,2011-01-04,2011-07-06,339,1,183,1030.3999999999999,183.0,156
13255,2010-12-01,2011-11-30,373,1,364,399.51000000000005,364.0,9
13258,2011-05-18,2011-11-28,205,2,194,698.5799999999999,97.0,11
13259,2011-10-09,2011-10-09,61,0,0,292.3199999999999,0.0,61
13260,2011-10-09,2011-10-09,61,0,0,557.6200000000001,0.0,61
13261,2011-02-27,2011-03-16,285,1,17,944.1,17.0,268
13262,2011-03-21,2011-03-21,263,0,0,200.29000000000002,0.0,263
13263,2011-01-18,2011-12-08,325,32,324,7454.069999999956,10.0,1
13265,2011-03-11,2011-10-17,273,4,220,2107.6600000000008,55.0,53
13266,2011-03-28,2011-11-28,256,11,245,3834.26,22.0,11
13267,2010-12-08,2011-12-07,366,13,364,4521.490000000001,28.0,2
13268,2011-03-17,2011-11-22,267,9,250,3214.6899999999996,28.0,17
13269,2010-12-05,2011-12-08,369,12,368,5346.23,31.0,1
13270,2010-12-08,2010-12-08,366,0,0,590.0,0.0,366
13271,2011-11-02,2011-11-02,37,0,0,217.3799999999999,0.0,37
13272,2011-09-11,2011-11-08,89,1,58,276.56000000000006,58.0,31
13273,2011-08-18,2011-08-18,113,0,0,138.97999999999996,0.0,113
13276,2011-09-01,2011-10-07,99,1,36,590.93,36.0,63
13277,2011-07-29,2011-11-24,133,3,118,258.4,39.0,15
13278,2011-10-30,2011-10-30,40,0,0,542.73,0.0,40
13279,2011-09-22,2011-09-22,78,0,0,137.75000000000003,0.0,78
13280,2011-01-06,2011-08-09,337,2,215,814.8600000000001,108.0,122
13282,2011-05-03,2011-11-21,220,2,202,1132.1399999999999,101.0,18
13283,2011-06-07,2011-10-11,185,1,126,93.66,126.0,59
13284,2011-01-13,2011-01-13,330,0,0,201.19,0.0,330
13285,2011-02-22,2011-11-16,290,3,267,2709.1200000000003,89.0,23
13291,2011-07-07,2011-07-07,155,0,0,361.10999999999996,0.0,155
13292,2011-02-28,2011-11-01,284,1,246,578.9399999999999,246.0,38
13294,2011-04-04,2011-06-03,249,1,60,873.7399999999998,60.0,189
13295,2010-12-15,2010-12-15,359,0,0,201.20000000000007,0.0,359
13296,2011-07-25,2011-07-25,137,0,0,87.4,0.0,137
13297,2011-10-03,2011-12-02,67,2,60,2089.8500000000004,30.0,7
13298,2011-12-08,2011-12-08,1,0,0,360.0,0.0,1
13299,2011-03-16,2011-03-16,268,0,0,142.50000000000003,0.0,268
13300,2011-06-23,2011-06-23,169,0,0,371.89000000000004,0.0,169
13301,2011-02-20,2011-08-28,292,3,189,618.0899999999998,63.0,103
13302,2011-07-07,2011-07-07,155,0,0,63.75,0.0,155
13304,2010-12-23,2010-12-23,351,0,0,300.4199999999999,0.0,351
13305,2010-12-02,2011-12-05,372,9,368,2000.8599999999992,41.0,4
13307,2011-08-11,2011-08-11,120,0,0,15.0,0.0,120
13308,2011-05-20,2011-11-17,203,2,181,1385.51,90.0,22
13309,2011-02-04,2011-12-02,308,4,301,1456.7899999999993,75.0,7
13310,2011-01-19,2011-11-11,324,2,296,1132.0300000000002,148.0,28
13311,2011-07-12,2011-12-05,150,1,146,598.57,146.0,4
13313,2011-01-04,2011-11-17,339,4,317,1555.3199999999993,79.0,22
13314,2011-09-27,2011-12-08,73,2,72,775.9400000000002,36.0,1
13316,2011-03-30,2011-11-02,254,3,217,5977.730000000001,72.0,37
13317,2010-12-16,2011-10-04,358,3,292,2273.679999999999,97.0,66
13318,2011-11-02,2011-12-08,37,2,36,640.76,18.0,1
13319,2010-12-09,2011-12-04,365,16,360,10845.549999999988,22.0,5
13320,2011-05-10,2011-09-22,213,2,135,1548.7000000000003,68.0,78
13321,2011-09-14,2011-09-28,86,1,14,567.3600000000001,14.0,72
13322,2011-11-22,2011-11-22,17,0,0,199.48,0.0,17
13323,2011-09-16,2011-12-06,84,4,81,787.85,20.0,3
13324,2010-12-14,2011-11-03,360,5,324,7121.949999999994,65.0,36
13325,2011-09-19,2011-09-19,81,0,0,675.3,0.0,81
13327,2010-12-09,2011-11-01,365,6,327,3627.7699999999986,54.0,38
13328,2011-01-27,2011-01-27,316,0,0,1308.48,0.0,316
13329,2010-12-08,2011-11-08,366,1,335,789.0,335.0,31
13330,2011-01-28,2011-09-08,315,2,223,1140.9299999999996,112.0,92
13332,2011-11-25,2011-11-25,14,0,0,350.9,0.0,14
13334,2011-02-07,2011-09-18,305,2,223,3536.819999999998,112.0,82
13336,2011-09-23,2011-09-23,77,0,0,795.12,0.0,77
13338,2011-07-05,2011-07-05,157,0,0,487.02000000000004,0.0,157
13339,2011-05-23,2011-05-23,200,0,0,860.1200000000002,0.0,200
13340,2011-03-08,2011-10-25,276,4,231,10736.47999999999,58.0,45
13341,2011-03-24,2011-03-24,260,0,0,775.85,0.0,260
13343,2011-06-15,2011-06-15,177,0,0,353.43000000000006,0.0,177
13344,2011-03-07,2011-10-03,277,1,210,2543.720000000002,210.0,67
13345,2011-02-25,2011-02-25,287,0,0,389.50000000000006,0.0,287
13347,2011-09-30,2011-09-30,70,0,0,341.36,0.0,70
13348,2011-10-06,2011-10-06,64,0,0,233.76000000000002,0.0,64
13349,2011-11-29,2011-11-29,10,0,0,247.31999999999996,0.0,10
13350,2011-09-21,2011-11-23,79,1,63,979.1199999999999,63.0,16
13351,2011-10-04,2011-10-04,66,0,0,373.94000000000005,0.0,66
13352,2011-10-10,2011-10-10,60,0,0,397.9800000000001,0.0,60
13354,2011-09-29,2011-09-29,71,0,0,743.5300000000003,0.0,71
13355,2011-08-09,2011-08-09,122,0,0,674.7,0.0,122
13356,2011-09-20,2011-09-20,80,0,0,768.2400000000001,0.0,80
13357,2011-03-27,2011-03-27,257,0,0,609.9500000000002,0.0,257
13358,2011-03-16,2011-03-16,268,0,0,439.03000000000003,0.0,268
13359,2011-10-07,2011-10-07,63,0,0,439.55999999999995,0.0,63
13362,2011-02-25,2011-11-30,287,3,278,3090.7399999999984,93.0,9
13363,2011-10-27,2011-11-22,43,1,26,992.5000000000002,26.0,17
13364,2011-09-29,2011-09-29,71,0,0,134.96,0.0,71
13365,2011-05-06,2011-11-06,217,1,184,2225.3700000000013,184.0,33
13366,2011-10-20,2011-10-20,50,0,0,56.16,0.0,50
13368,2011-01-06,2011-03-28,337,1,81,623.4,81.0,256
13369,2010-12-09,2010-12-09,365,0,0,308.28000000000003,0.0,365
13370,2010-12-03,2010-12-03,371,0,0,754.8700000000003,0.0,371
13372,2011-09-11,2011-09-11,89,0,0,378.64,0.0,89
13373,2011-03-08,2011-10-10,276,2,216,3312.2500000000005,108.0,60
13375,2011-09-12,2011-09-12,88,0,0,778.6499999999997,0.0,88
13376,2011-04-19,2011-09-01,234,2,135,1019.7600000000003,68.0,99
13379,2011-07-26,2011-11-13,136,2,110,572.5599999999997,55.0,26
13381,2011-02-14,2011-11-08,298,5,267,3639.3100000000004,53.0,31
13382,2011-03-04,2011-03-04,280,0,0,222.99000000000004,0.0,280
13384,2011-06-14,2011-11-09,178,5,148,4151.929999999999,30.0,30
13385,2011-01-14,2011-01-14,329,0,0,534.5700000000002,0.0,329
13388,2011-07-31,2011-07-31,131,0,0,677.1000000000001,0.0,131
13389,2011-04-21,2011-11-28,232,2,221,797.96,110.0,11
13390,2011-09-26,2011-09-26,74,0,0,544.0799999999999,0.0,74
13391,2011-05-20,2011-05-20,203,0,0,59.8,0.0,203
13394,2011-02-03,2011-12-08,309,7,308,2520.0199999999995,44.0,1
13395,2011-06-07,2011-06-07,185,0,0,307.72,0.0,185
13396,2011-01-24,2011-11-10,319,1,290,1360.9899999999998,290.0,29
13397,2011-01-04,2011-09-28,339,4,267,1544.1299999999997,67.0,72
13398,2011-05-31,2011-05-31,192,0,0,457.3400000000001,0.0,192
13402,2010-12-02,2011-08-04,372,1,245,621.2300000000002,245.0,127
13403,2011-11-22,2011-11-22,17,0,0,75.0,0.0,17
13404,2011-05-11,2011-12-08,212,1,211,252.48999999999998,211.0,1
13405,2011-01-26,2011-09-26,317,2,243,572.4509999999999,122.0,74
13408,2010-12-01,2011-12-08,373,40,372,28117.039999999983,9.0,1
13410,2011-02-21,2011-11-15,291,4,267,1003.0600000000001,67.0,24
13411,2011-08-24,2011-08-24,107,0,0,213.55000000000004,0.0,107
13414,2011-02-16,2011-07-29,296,2,163,1390.5,82.0,133
13416,2011-09-19,2011-10-27,81,1,38,712.5000000000001,38.0,43
13417,2011-05-18,2011-12-05,205,1,201,640.83,201.0,4
13418,2010-12-02,2011-11-28,372,12,361,6127.429999999998,30.0,11
13419,2011-10-07,2011-10-07,63,0,0,221.06000000000003,0.0,63
13420,2011-06-22,2011-07-13,170,1,21,159.85,21.0,149
13421,2011-02-22,2011-10-30,290,1,250,1851.0799999999995,250.0,40
13422,2011-10-06,2011-10-06,64,0,0,2626.3000000000006,0.0,64
13425,2011-02-18,2011-08-23,294,2,186,1624.2099999999998,93.0,108
13426,2010-12-15,2011-12-09,359,9,359,3641.3199999999974,40.0,0
13427,2011-05-08,2011-11-20,215,2,196,582.6,98.0,19
13428,2011-11-29,2011-11-29,10,0,0,218.46999999999994,0.0,10
13429,2011-09-25,2011-11-29,75,3,65,1006.8000000000001,22.0,10
13430,2011-09-14,2011-11-21,86,1,68,679.45,68.0,18
13431,2011-09-12,2011-10-03,88,1,21,1269.0999999999997,21.0,67
13434,2011-09-04,2011-09-26,96,1,22,534.2400000000001,22.0,74
13435,2011-06-03,2011-12-04,189,6,184,3809.89,31.0,5
13436,2011-12-08,2011-12-08,1,0,0,196.88999999999996,0.0,1
13437,2011-06-02,2011-11-25,190,6,176,3408.0599999999995,29.0,14
13439,2011-03-29,2011-03-29,255,0,0,283.71,0.0,255
13441,2011-09-09,2011-09-09,91,0,0,296.64000000000004,0.0,91
13447,2011-11-04,2011-11-16,35,2,12,1129.14,6.0,23
13448,2010-12-01,2011-11-23,373,4,357,3539.370000000002,89.0,16
13449,2011-11-16,2011-11-16,23,0,0,291.88,0.0,23
13450,2011-05-05,2011-11-13,218,5,192,2043.7200000000005,38.0,26
13451,2011-01-09,2011-11-13,334,4,308,2976.149999999999,77.0,26
13452,2011-03-14,2011-03-25,270,1,11,590.0,11.0,259
13453,2011-02-23,2011-06-27,289,1,124,356.98,124.0,165
13455,2010-12-08,2011-11-15,366,1,342,1058.3400000000001,342.0,24
13456,2011-05-16,2011-11-22,207,5,190,1766.7199999999998,38.0,17
13458,2010-12-15,2011-12-02,359,13,352,9646.570000000002,27.0,7
13460,2011-10-21,2011-11-10,49,1,20,183.44000000000003,20.0,29
13461,2011-06-29,2011-11-01,163,2,125,1445.0000000000002,62.0,38
13462,2011-04-01,2011-04-01,252,0,0,151.5,0.0,252
13464,2011-10-12,2011-10-12,58,0,0,674.6800000000002,0.0,58
13466,2011-06-08,2011-06-08,184,0,0,307.90000000000003,0.0,184
13467,2011-11-03,2011-11-29,36,1,26,1083.71,26.0,10
13468,2010-12-01,2011-12-08,373,35,372,5704.970000000001,11.0,1
13470,2011-08-16,2011-09-01,115,1,16,165.0,16.0,99
13471,2011-10-23,2011-12-08,47,3,46,2531.579999999998,15.0,1
13473,2011-01-11,2011-10-10,332,1,272,422.64,272.0,60
13474,2011-04-17,2011-04-17,236,0,0,229.58999999999997,0.0,236
13475,2011-02-14,2011-06-01,298,3,107,1431.7800000000009,36.0,191
13476,2011-03-03,2011-06-14,281,1,103,1238.4699999999998,103.0,178
13477,2011-02-21,2011-11-02,291,5,254,1454.579999999999,51.0,37
13479,2011-04-19,2011-05-23,234,1,34,300.95,34.0,200
13481,2011-03-28,2011-10-25,256,3,211,1804.5599999999993,70.0,45
13482,2011-04-21,2011-04-21,232,0,0,184.64000000000001,0.0,232
13483,2011-10-05,2011-10-05,65,0,0,140.34000000000003,0.0,65
13484,2011-04-12,2011-04-12,241,0,0,313.79999999999995,0.0,241
13485,2011-04-20,2011-04-20,233,0,0,454.2400000000001,0.0,233
13486,2011-07-07,2011-09-22,155,2,77,1122.4099999999999,38.0,78
13487,2010-12-21,2011-10-13,353,2,296,575.4000000000001,148.0,57
13488,2010-12-07,2011-11-22,367,11,350,8968.309999999996,32.0,17
13489,2011-02-18,2011-08-26,294,3,189,449.52000000000004,63.0,105
13491,2010-12-02,2011-10-19,372,9,321,1215.82,36.0,51
13492,2011-05-09,2011-07-26,214,2,78,1269.8400000000006,39.0,136
13493,2011-02-25,2011-03-09,287,1,12,618.6300000000001,12.0,275
13494,2011-02-01,2011-02-01,311,0,0,316.26,0.0,311
13495,2010-12-06,2011-12-02,368,4,361,2044.87,90.0,7
13496,2010-12-15,2011-11-29,359,1,349,653.3299999999999,349.0,10
13497,2010-12-06,2011-03-02,368,1,86,348.05,86.0,282
13499,2011-03-15,2011-11-22,269,4,252,1159.11,63.0,17
13500,2011-08-09,2011-11-16,122,2,99,1166.7700000000002,50.0,23
13501,2011-02-24,2011-02-24,288,0,0,1340.3199999999997,0.0,288
13502,2011-01-20,2011-11-23,323,2,307,292.0,154.0,16
13503,2011-09-29,2011-09-29,71,0,0,216.84999999999997,0.0,71
13504,2011-10-06,2011-10-06,64,0,0,295.93,0.0,64
13505,2011-04-21,2011-09-28,232,3,160,4393.629999999999,53.0,72
13506,2010-12-05,2011-01-27,369,1,53,458.52000000000004,53.0,316
13507,2011-07-17,2011-12-06,145,3,142,2479.159999999999,47.0,3
13508,2011-04-10,2011-04-10,243,0,0,110.97,0.0,243
13509,2011-02-28,2011-12-01,284,6,276,979.7200000000001,46.0,8
13510,2011-06-09,2011-12-08,183,3,182,1791.5599999999984,61.0,1
13512,2011-03-24,2011-03-24,260,0,0,251.20999999999998,0.0,260
13513,2011-08-05,2011-08-05,126,0,0,205.10000000000002,0.0,126
13514,2011-09-27,2011-09-27,73,0,0,152.20000000000005,0.0,73
13515,2011-04-06,2011-09-28,247,3,175,891.1200000000002,58.0,72
13516,2011-04-15,2011-11-18,238,2,217,1389.4100000000003,108.0,21
13517,2011-06-13,2011-10-11,179,2,120,2128.42,60.0,59
13518,2011-09-15,2011-09-15,85,0,0,659.4399999999998,0.0,85
13519,2011-09-22,2011-09-22,78,0,0,122.74999999999999,0.0,78
13520,2010-12-03,2011-10-12,371,5,313,3624.349999999999,63.0,58
13521,2011-11-29,2011-12-08,10,2,9,1093.6500000000003,4.0,1
13522,2011-11-09,2011-11-09,30,0,0,125.80000000000001,0.0,30
13523,2010-12-08,2011-11-06,366,3,333,3964.8800000000006,111.0,33
13524,2011-05-04,2011-10-30,219,4,179,680.1800000000002,45.0,40
13525,2011-04-05,2011-11-25,248,1,234,628.78,234.0,14
13527,2011-01-17,2011-11-06,326,5,293,2287.5100000000007,59.0,33
13529,2011-05-19,2011-09-22,204,1,126,307.76,126.0,78
13531,2010-12-08,2011-05-18,366,1,161,483.8000000000001,161.0,205
13532,2011-11-06,2011-11-06,33,0,0,210.30999999999983,0.0,33
13533,2011-03-17,2011-06-10,267,1,85,270.79000000000013,85.0,182
13534,2010-12-16,2011-12-07,358,17,356,5870.080000000015,21.0,2
13536,2011-09-25,2011-12-08,75,6,74,3448.2899999999986,12.0,1
13538,2011-01-28,2011-10-27,315,6,272,1280.85,45.0,43
13539,2011-02-03,2011-09-15,309,2,224,631.3400000000001,112.0,85
13544,2011-04-13,2011-10-31,240,1,201,291.4099999999999,201.0,39
13546,2011-05-23,2011-11-27,200,2,188,626.9899999999999,94.0,12
13548,2011-04-10,2011-09-04,243,1,147,682.4100000000001,147.0,96
13549,2011-04-11,2011-11-14,242,6,217,918.1999999999998,36.0,25
13551,2011-01-24,2011-01-24,319,0,0,91.80000000000001,0.0,319
13552,2011-01-28,2011-10-04,315,7,249,3740.070000000001,36.0,66
13555,2011-05-22,2011-09-27,201,1,128,4149.2800000000025,128.0,73
13557,2011-03-04,2011-11-11,280,1,252,584.0600000000001,252.0,28
13558,2011-10-02,2011-12-04,68,3,63,605.0599999999998,21.0,5
13560,2011-12-02,2011-12-02,7,0,0,174.37000000000003,0.0,7
13561,2011-05-08,2011-05-08,215,0,0,141.86,0.0,215
13562,2011-04-08,2011-09-19,245,2,164,1799.3299999999988,82.0,81
13563,2011-07-22,2011-09-16,140,1,56,777.5300000000001,56.0,84
13564,2010-12-06,2011-07-18,368,2,224,1749.0200000000004,112.0,144
13565,2011-01-09,2011-11-20,334,1,315,240.22000000000006,315.0,19
13566,2011-09-18,2011-10-30,82,1,42,874.7099999999997,42.0,40
13568,2011-06-19,2011-06-19,173,0,0,192.85000000000005,0.0,173
13569,2010-12-07,2011-11-22,367,1,350,373.74999999999994,350.0,17
13570,2011-04-10,2011-04-10,243,0,0,239.49000000000004,0.0,243
13571,2011-03-31,2011-11-27,253,11,241,2092.32,22.0,12
13572,2011-05-18,2011-05-18,205,0,0,1384.25,0.0,205
13573,2011-03-31,2011-10-20,253,1,203,294.4,203.0,50
13575,2011-06-16,2011-11-16,176,4,153,732.0699999999997,38.0,23
13576,2010-12-01,2011-11-29,373,17,363,6717.34,21.0,10
13577,2011-04-12,2011-11-14,241,3,216,1687.5999999999988,72.0,25
13579,2010-12-05,2011-11-25,369,1,355,467.04,355.0,14
13581,2011-02-03,2011-02-03,309,0,0,118.0,0.0,309
13583,2011-07-07,2011-07-07,155,0,0,781.0300000000002,0.0,155
13584,2011-02-06,2011-02-06,306,0,0,142.40000000000003,0.0,306
13587,2011-10-07,2011-10-07,63,0,0,712.4,0.0,63
13588,2011-03-29,2011-11-24,255,8,240,2478.949999999998,30.0,15
13589,2011-06-13,2011-11-25,179,1,165,379.65000000000003,165.0,14
13590,2011-02-09,2011-11-28,303,5,292,1981.9199999999994,58.0,11
13591,2011-03-18,2011-10-06,266,2,202,1117.1300000000003,101.0,64
13592,2011-03-20,2011-11-04,264,3,229,247.95999999999998,76.0,35
13593,2011-01-07,2011-08-23,336,4,228,2037.0800000000008,57.0,108
13594,2011-10-18,2011-10-18,52,0,0,396.96999999999997,0.0,52
13596,2011-11-27,2011-12-04,12,1,7,697.04,7.0,5
13598,2011-10-23,2011-10-23,47,0,0,180.1700000000001,0.0,47
13599,2010-12-08,2011-12-08,366,14,365,5153.669999999998,26.0,1
13600,2011-01-31,2011-01-31,312,0,0,219.52,0.0,312
13601,2011-05-12,2011-10-25,211,1,166,693.3200000000002,166.0,45
13602,2011-10-06,2011-10-06,64,0,0,428.88999999999993,0.0,64
13603,2011-11-13,2011-11-13,26,0,0,164.34,0.0,26
13606,2011-02-01,2011-11-10,311,2,282,280.53999999999996,141.0,29
13607,2011-10-30,2011-10-30,40,0,0,678.0099999999996,0.0,40
13610,2011-02-27,2011-11-27,285,6,273,1131.8800000000006,46.0,12
13611,2010-12-15,2011-09-11,359,2,270,1171.8000000000002,135.0,89
13614,2011-01-13,2011-11-15,330,3,306,1610.460000000001,102.0,24
13615,2011-01-25,2011-01-25,318,0,0,417.6900000000001,0.0,318
13617,2011-06-12,2011-10-30,180,2,140,544.1800000000001,70.0,40
13618,2011-06-19,2011-06-19,173,0,0,177.34000000000003,0.0,173
13621,2011-08-15,2011-08-15,116,0,0,213.85,0.0,116
13623,2011-02-15,2011-11-09,297,4,267,747.7800000000003,67.0,30
13626,2011-04-01,2011-04-01,252,0,0,257.22999999999996,0.0,252
13627,2010-12-17,2011-10-11,357,4,298,1638.4700000000003,74.0,59
13629,2011-01-05,2011-11-16,338,10,315,7792.36,32.0,23
13630,2011-02-27,2011-12-04,285,6,280,2031.7799999999997,47.0,5
13631,2011-03-17,2011-09-01,267,6,168,3070.42,28.0,99
13632,2011-04-10,2011-11-15,243,4,219,2121.27,55.0,24
13634,2011-01-16,2011-11-06,327,4,294,1575.1600000000003,74.0,33
13635,2011-10-03,2011-10-03,67,0,0,1071.0300000000002,0.0,67
13636,2011-02-27,2011-11-03,285,4,249,949.1199999999999,62.0,36
13637,2011-04-27,2011-10-18,226,2,174,810.4999999999998,87.0,52
13638,2011-11-24,2011-11-24,15,0,0,122.64,0.0,15
13639,2011-09-26,2011-09-26,74,0,0,1033.3400000000001,0.0,74
13642,2011-05-08,2011-05-08,215,0,0,354.7999999999999,0.0,215
13643,2011-06-07,2011-11-08,185,2,154,519.44,77.0,31
13644,2011-08-26,2011-11-23,105,3,89,2624.260000000001,30.0,16
13645,2011-08-11,2011-08-11,120,0,0,252.1,0.0,120
13647,2011-04-19,2011-11-30,234,3,225,1678.1200000000001,75.0,9
13649,2010-12-08,2011-03-28,366,1,110,346.6000000000001,110.0,256
13650,2011-03-17,2011-11-23,267,4,251,1836.34,63.0,16
13651,2011-10-31,2011-11-04,39,1,4,94.2,4.0,35
13652,2010-12-06,2011-10-25,368,2,323,1095.08,162.0,45
13654,2011-03-11,2011-10-27,273,4,230,2707.329999999999,58.0,43
13655,2011-04-12,2011-08-17,241,1,127,932.9700000000004,127.0,114
13656,2011-01-06,2011-06-28,337,1,173,379.65000000000003,173.0,164
13657,2011-05-22,2011-11-29,201,1,191,382.13999999999993,191.0,10
13658,2011-05-19,2011-11-30,204,2,195,2639.1700000000037,98.0,9
13659,2011-01-23,2011-05-18,320,1,115,1573.2000000000007,115.0,205
13662,2011-03-25,2011-09-15,259,2,174,897.7600000000001,87.0,85
13663,2011-06-13,2011-06-13,179,0,0,189.47,0.0,179
13666,2011-02-25,2011-10-10,287,1,227,84.65000000000002,227.0,60
13667,2011-07-13,2011-07-13,149,0,0,305.0199999999998,0.0,149
13668,2010-12-12,2011-12-07,362,20,360,6363.589999999984,18.0,2
13669,2011-07-13,2011-10-20,149,1,99,218.55,99.0,50
13670,2011-09-25,2011-09-25,75,0,0,349.70000000000016,0.0,75
13672,2011-01-11,2011-02-11,332,1,31,186.39000000000001,31.0,301
13673,2011-11-07,2011-11-21,32,1,14,396.9199999999999,14.0,18
13675,2011-02-28,2011-07-11,284,1,133,486.8200000000001,133.0,151
13678,2011-07-11,2011-07-11,151,0,0,232.60000000000005,0.0,151
13680,2011-01-04,2011-12-08,339,3,338,3722.4200000000014,113.0,1
13681,2011-07-07,2011-11-22,155,3,138,827.8300000000002,46.0,17
13682,2011-06-05,2011-06-05,187,0,0,59.5,0.0,187
13684,2011-02-27,2011-02-27,285,0,0,67.23000000000002,0.0,285
13685,2011-10-10,2011-12-07,60,5,58,3119.4400000000014,12.0,2
13686,2011-06-10,2011-06-10,182,0,0,72.0,0.0,182
13689,2011-10-07,2011-10-07,63,0,0,910.0,0.0,63
13690,2011-10-11,2011-10-11,59,0,0,172.25,0.0,59
13692,2011-04-17,2011-11-15,236,2,212,1488.3200000000004,106.0,24
13694,2010-12-01,2011-12-06,373,34,370,65039.620000000024,11.0,3
13695,2011-03-25,2011-11-08,259,13,228,2504.1299999999987,18.0,31
13697,2011-11-01,2011-11-01,38,0,0,151.3,0.0,38
13699,2011-07-07,2011-07-07,155,0,0,308.58,0.0,155
13700,2011-01-16,2011-11-13,327,7,301,2265.119999999999,43.0,26
13703,2011-01-25,2011-01-25,318,0,0,99.5,0.0,318
13704,2011-09-12,2011-12-04,88,8,83,2308.0599999999986,10.0,5
13705,2010-12-01,2011-12-02,373,2,366,711.8600000000001,183.0,7
13706,2011-02-10,2011-02-10,302,0,0,330.79,0.0,302
13707,2011-01-28,2011-03-17,315,1,48,806.4100000000005,48.0,267
13708,2011-03-13,2011-03-13,271,0,0,296.87999999999994,0.0,271
13709,2011-01-28,2011-12-06,315,7,312,6328.050000000004,45.0,3
13710,2011-11-08,2011-11-08,31,0,0,180.48000000000002,0.0,31
13711,2011-05-05,2011-05-05,218,0,0,252.06000000000003,0.0,218
13712,2011-04-07,2011-04-07,246,0,0,228.84,0.0,246
13715,2010-12-02,2011-03-03,372,3,91,1079.34,30.0,281
13716,2011-03-15,2011-03-15,269,0,0,138.28,0.0,269
13717,2011-02-14,2011-11-07,298,5,266,1445.0100000000002,53.0,32
13718,2011-02-17,2011-04-07,295,1,49,306.55,49.0,246
13719,2011-04-19,2011-11-24,234,4,219,1041.68,55.0,15
13720,2011-03-30,2011-08-15,254,3,138,799.8999999999999,46.0,116
13721,2011-11-03,2011-11-03,36,0,0,524.14,0.0,36
13722,2011-03-02,2011-07-31,282,1,151,2375.4100000000008,151.0,131
13723,2011-05-06,2011-05-06,217,0,0,199.85000000000002,0.0,217
13725,2011-02-04,2011-10-21,308,7,259,1980.5600000000004,37.0,49
13726,2011-08-31,2011-11-01,100,1,62,1079.6600000000003,62.0,38
13727,2011-11-06,2011-11-11,33,1,5,333.4800000000001,5.0,28
13728,2011-02-02,2011-11-03,310,5,274,1016.1399999999999,55.0,36
13730,2011-07-01,2011-07-27,161,1,26,752.5999999999998,26.0,135
13731,2011-04-07,2011-05-04,246,1,27,610.5899999999999,27.0,219
13732,2011-11-11,2011-11-11,28,0,0,491.86000000000007,0.0,28
13735,2011-04-19,2011-11-15,234,3,210,2885.2399999999975,70.0,24
13736,2011-03-24,2011-12-04,260,1,255,731.9,255.0,5
13737,2011-05-23,2011-05-23,200,0,0,339.59999999999997,0.0,200
13739,2011-11-21,2011-11-21,18,0,0,216.9,0.0,18
13740,2011-04-13,2011-04-13,240,0,0,350.75000000000006,0.0,240
13741,2011-05-06,2011-09-29,217,2,146,668.4300000000001,73.0,71
13742,2011-01-23,2011-11-23,320,10,304,3131.020000000001,30.0,16
13743,2011-03-25,2011-12-07,259,6,257,1341.5999999999997,43.0,2
13744,2011-02-20,2011-09-05,292,1,197,1156.36,197.0,95
13745,2011-06-30,2011-06-30,162,0,0,300.04,0.0,162
13747,2010-12-01,2010-12-01,373,0,0,79.6,0.0,373
13748,2010-12-01,2011-09-05,373,3,278,948.2499999999998,93.0,95
13750,2011-01-07,2011-10-17,336,4,283,1647.2599999999998,71.0,53
13751,2011-02-24,2011-02-24,288,0,0,296.24999999999994,0.0,288
13752,2011-04-07,2011-08-07,246,5,122,1186.2800000000002,24.0,124
13753,2011-02-25,2011-02-25,287,0,0,741.26,0.0,287
13754,2011-01-26,2011-07-11,317,1,166,282.6,166.0,151
13755,2011-10-07,2011-12-06,63,7,60,2161.3500000000013,9.0,3
13756,2010-12-07,2011-12-07,367,11,365,5189.519999999995,33.0,2
13758,2010-12-01,2011-11-28,373,6,362,3190.550000000001,60.0,11
13759,2011-09-29,2011-11-06,71,1,38,659.41,38.0,33
13760,2011-03-28,2011-10-16,256,1,202,286.78999999999996,202.0,54
13761,2011-06-13,2011-10-20,179,1,129,1070.65,129.0,50
13762,2011-05-05,2011-05-05,218,0,0,306.72,0.0,218
13763,2011-10-07,2011-10-07,63,0,0,1714.96,0.0,63
13764,2011-01-06,2011-09-30,337,2,267,1521.7600000000002,134.0,70
13767,2010-12-01,2011-12-07,373,30,371,17220.360000000008,12.0,2
13769,2010-12-07,2011-12-07,367,8,365,2796.5099999999993,46.0,2
13771,2011-04-06,2011-10-06,247,2,183,2634.450000000001,92.0,64
13772,2011-04-14,2011-11-06,239,2,206,1132.13,103.0,33
13774,2011-09-19,2011-09-19,81,0,0,344.99999999999994,0.0,81
13777,2010-12-01,2011-12-09,373,23,373,25977.159999999985,16.0,0
13778,2011-08-28,2011-08-28,103,0,0,178.7,0.0,103
13780,2011-06-22,2011-12-02,170,1,163,360.01,163.0,7
13781,2011-04-03,2011-04-03,250,0,0,127.84000000000002,0.0,250
13782,2011-01-16,2011-11-27,327,5,315,911.9999999999992,63.0,12
13784,2011-01-11,2011-11-30,332,10,323,2462.7899999999995,32.0,9
13786,2010-12-07,2010-12-07,367,0,0,230.4,0.0,367
13787,2010-12-10,2011-09-25,364,1,289,309.04,289.0,75
13790,2011-12-05,2011-12-05,4,0,0,348.79999999999995,0.0,4
13791,2011-06-24,2011-08-04,168,1,41,1516.0,41.0,127
13792,2011-02-25,2011-10-04,287,1,221,195.54999999999995,221.0,66
13798,2010-12-02,2011-12-08,372,52,371,37153.84999999998,7.0,1
13799,2011-02-18,2011-08-15,294,1,178,688.8600000000002,178.0,116
13800,2011-02-03,2011-02-03,309,0,0,558.3199999999998,0.0,309
13801,2011-10-04,2011-10-04,66,0,0,324.8,0.0,66
13802,2011-02-01,2011-07-24,311,2,173,4599.420000000001,86.0,138
13803,2011-03-29,2011-03-29,255,0,0,277.07000000000005,0.0,255
13804,2011-02-23,2011-11-09,289,5,259,2635.7900000000004,52.0,30
13805,2011-08-02,2011-10-18,129,1,77,924.5999999999999,77.0,52
13806,2011-10-07,2011-10-07,63,0,0,256.38,0.0,63
13807,2010-12-07,2010-12-07,367,0,0,112.6,0.0,367
13808,2011-09-04,2011-12-04,96,4,91,1747.66,23.0,5
13809,2011-02-07,2011-02-07,305,0,0,155.05,0.0,305
13810,2011-10-14,2011-11-11,56,1,28,1499.01,28.0,28
13811,2011-04-14,2011-06-09,239,2,56,814.5,28.0,183
13812,2011-08-26,2011-10-28,105,2,63,539.0,32.0,42
13813,2011-07-28,2011-10-31,134,3,95,1366.8599999999997,32.0,39
13814,2011-07-25,2011-09-08,137,1,45,1579.1200000000003,45.0,92
13815,2011-01-25,2011-11-17,318,3,296,4027.3599999999983,99.0,22
13816,2011-10-06,2011-11-16,64,1,41,571.6700000000001,41.0,23
13817,2010-12-23,2011-11-10,351,1,322,382.9799999999999,322.0,29
13819,2011-01-24,2011-02-11,319,2,18,1140.35,9.0,301
13821,2011-03-23,2011-07-18,261,1,117,385.64,117.0,144
13822,2011-10-30,2011-12-04,40,1,35,632.0000000000001,35.0,5
13823,2011-09-09,2011-11-21,91,1,73,957.6600000000002,73.0,18
13824,2011-02-02,2011-11-07,310,4,278,1698.9399999999998,70.0,32
13826,2011-06-16,2011-06-16,176,0,0,189.5,0.0,176
13827,2011-07-19,2011-10-13,143,2,86,412.0499999999998,43.0,57
13828,2011-11-17,2011-11-17,22,0,0,209.49000000000004,0.0,22
13831,2010-12-05,2011-11-23,369,5,353,2202.99,71.0,16
13832,2011-11-20,2011-11-20,19,0,0,52.2,0.0,19
13833,2011-07-03,2011-07-03,159,0,0,384.7999999999999,0.0,159
13835,2011-05-08,2011-11-14,215,3,190,834.57,63.0,25
13837,2011-01-26,2011-05-12,317,1,106,271.24000000000007,106.0,211
13838,2010-12-05,2011-12-04,369,2,364,691.7299999999999,182.0,5
13841,2011-04-01,2011-04-01,252,0,0,85.0,0.0,252
13842,2010-12-08,2011-10-12,366,8,308,3385.619999999999,38.0,58
13844,2011-11-28,2011-11-28,11,0,0,361.62,0.0,11
13845,2011-10-06,2011-10-06,64,0,0,312.98,0.0,64
13846,2010-12-14,2011-11-15,360,2,336,865.0600000000005,168.0,24
13848,2010-12-08,2011-09-08,366,2,274,1255.0,137.0,92
13849,2011-06-22,2011-10-19,170,1,119,1537.95,119.0,51
13850,2011-08-02,2011-08-02,129,0,0,1595.4799999999996,0.0,129
13851,2011-02-24,2011-09-05,288,2,193,2651.46,96.0,95
13853,2011-10-13,2011-10-13,57,0,0,1090.1399999999999,0.0,57
13854,2010-12-09,2011-12-01,365,24,357,8109.5199999999995,15.0,8
13856,2011-05-20,2011-06-24,203,2,35,388.5,18.0,168
13858,2011-10-13,2011-10-13,57,0,0,216.16999999999996,0.0,57
13859,2011-01-17,2011-01-17,326,0,0,201.16,0.0,326
13860,2011-09-14,2011-12-08,86,3,85,1245.9000000000003,28.0,1
13862,2011-01-11,2011-11-21,332,7,314,2209.360000000001,45.0,18
13863,2011-04-06,2011-04-06,247,0,0,305.78000000000003,0.0,247
13865,2011-02-23,2011-10-12,289,3,231,501.56,77.0,58
13866,2011-09-26,2011-09-26,74,0,0,145.67000000000002,0.0,74
13867,2011-05-05,2011-11-08,218,2,187,1015.2900000000002,94.0,31
13868,2011-11-01,2011-12-02,38,1,31,3192.54,31.0,7
13869,2010-12-17,2011-08-08,357,3,234,3104.9500000000035,78.0,123
13870,2011-02-25,2011-12-07,287,5,285,2770.9400000000005,57.0,2
13871,2011-02-04,2011-11-17,308,11,286,6403.250000000004,26.0,22
13873,2011-02-03,2011-08-12,309,2,190,389.6,95.0,119
13874,2010-12-16,2010-12-16,358,0,0,540.45,0.0,358
13875,2011-02-11,2011-10-17,301,4,248,1786.7900000000004,62.0,53
13876,2011-10-07,2011-10-07,63,0,0,122.69999999999999,0.0,63
13877,2011-09-14,2011-09-14,86,0,0,117.23999999999998,0.0,86
13878,2011-10-16,2011-10-16,54,0,0,1281.53,0.0,54
13880,2010-12-07,2011-11-18,367,9,346,3219.770000000001,38.0,21
13881,2011-02-01,2011-12-06,311,15,308,17159.519999999993,21.0,3
13882,2011-10-06,2011-12-07,64,4,62,1191.1299999999999,16.0,2
13883,2011-03-31,2011-11-29,253,2,243,2674.4799999999987,122.0,10
13884,2011-03-01,2011-12-02,283,3,276,787.6000000000001,92.0,7
13885,2011-05-23,2011-06-03,200,1,11,506.8000000000001,11.0,189
13886,2011-09-29,2011-09-29,71,0,0,243.56000000000003,0.0,71
13887,2011-05-19,2011-05-19,204,0,0,349.54999999999995,0.0,204
13888,2011-05-05,2011-08-12,218,1,99,605.63,99.0,119
13889,2011-09-08,2011-09-08,92,0,0,416.9000000000002,0.0,92
13890,2010-12-16,2011-12-08,358,8,357,1883.8099999999995,45.0,1
13892,2011-04-07,2011-11-13,246,3,220,632.97,73.0,26
13893,2011-02-15,2011-02-15,297,0,0,821.1,0.0,297
13894,2011-02-02,2011-11-16,310,1,287,564.62,287.0,23
13895,2011-06-28,2011-11-11,164,3,136,2593.0699999999993,45.0,28
13897,2011-10-20,2011-10-20,50,0,0,311.15999999999997,0.0,50
13898,2011-01-18,2011-01-18,325,0,0,155.93,0.0,325
13899,2011-03-10,2011-11-23,274,1,258,388.52000000000004,258.0,16
13900,2011-03-22,2011-06-09,262,2,79,740.9499999999997,40.0,183
13901,2011-01-25,2011-09-28,318,4,246,2867.2,62.0,72
13904,2011-02-18,2011-11-02,294,1,257,332.64,257.0,37
13908,2011-03-08,2011-09-21,276,3,197,2369.5499999999984,66.0,79
13911,2011-02-04,2011-10-13,308,8,251,2580.909999999999,31.0,57
13914,2011-11-03,2011-11-28,36,1,25,626.45,25.0,11
13917,2011-06-01,2011-10-21,191,1,142,272.0400000000001,142.0,49
13918,2011-03-31,2011-10-21,253,1,204,1212.8400000000001,204.0,49
13919,2011-08-10,2011-10-11,121,1,62,384.81,62.0,59
13922,2010-12-23,2010-12-23,351,0,0,172.24999999999997,0.0,351
13923,2011-10-17,2011-10-17,53,0,0,351.13000000000005,0.0,53
13924,2011-09-28,2011-12-08,72,5,71,1838.8500000000001,14.0,1
13925,2011-07-28,2011-09-08,134,2,42,678.2499999999999,21.0,92
13926,2011-11-16,2011-11-16,23,0,0,223.85000000000002,0.0,23
13927,2011-09-26,2011-09-26,74,0,0,348.99,0.0,74
13928,2011-07-29,2011-11-29,133,3,123,464.56999999999994,41.0,10
13929,2011-01-17,2011-06-23,326,1,157,842.6500000000001,157.0,169
13930,2011-07-26,2011-10-13,136,1,79,337.3399999999999,79.0,57
13931,2011-03-04,2011-09-05,280,1,185,1237.5300000000002,185.0,95
13932,2011-02-18,2011-02-18,294,0,0,307.4,0.0,294
13933,2011-07-14,2011-08-22,148,1,39,608.7899999999998,39.0,109
13934,2011-03-21,2011-03-21,263,0,0,922.0999999999998,0.0,263
13936,2011-06-13,2011-06-13,179,0,0,376.58,0.0,179
13937,2011-06-23,2011-06-23,169,0,0,158.85,0.0,169
13938,2011-11-04,2011-11-04,35,0,0,71.66,0.0,35
13939,2011-02-01,2011-11-16,311,2,288,568.55,144.0,23
13940,2011-07-18,2011-11-22,144,3,127,839.1400000000002,42.0,17
13941,2010-12-02,2011-11-18,372,4,351,5112.960000000001,88.0,21
13946,2011-03-17,2011-09-21,267,2,188,561.57,94.0,79
13947,2011-10-05,2011-10-05,65,0,0,90.60000000000001,0.0,65
13948,2010-12-14,2010-12-14,360,0,0,101.99999999999999,0.0,360
13949,2011-09-06,2011-12-07,94,5,92,2427.3199999999974,18.0,2
13950,2011-04-07,2011-11-28,246,3,235,745.0600000000001,78.0,11
13951,2011-02-18,2011-06-16,294,2,118,674.4499999999998,59.0,176
13952,2011-04-15,2011-05-06,238,1,21,3251.071,21.0,217
13953,2010-12-22,2011-12-02,352,6,345,3515.6800000000003,58.0,7
13954,2011-09-30,2011-12-08,70,1,69,439.92,69.0,1
13955,2011-02-07,2011-07-08,305,1,151,322.96000000000004,151.0,154
13956,2011-03-13,2011-12-04,271,4,266,1026.4200000000003,66.0,5
13959,2010-12-12,2011-09-21,362,2,283,598.1999999999999,142.0,79
13960,2011-09-29,2011-11-18,71,1,50,230.22000000000006,50.0,21
13962,2011-04-08,2011-11-18,245,1,224,169.55,224.0,21
13963,2010-12-07,2011-02-04,367,3,59,664.54,20.0,308
13967,2011-07-17,2011-07-17,145,0,0,80.7,0.0,145
13969,2010-12-09,2011-12-02,365,16,358,9053.940000000002,22.0,7
13971,2011-02-27,2011-11-21,285,7,267,2758.26,38.0,18
13972,2011-05-22,2011-09-30,201,1,131,190.25000000000009,131.0,70
13973,2011-02-25,2011-02-25,287,0,0,264.7,0.0,287
13974,2011-10-21,2011-10-21,49,0,0,413.59,0.0,49
13975,2011-03-08,2011-11-08,276,4,245,2526.2799999999993,61.0,31
13976,2011-05-17,2011-05-17,206,0,0,357.9800000000001,0.0,206
13978,2011-10-25,2011-11-25,45,1,31,196.78999999999996,31.0,14
13979,2011-09-27,2011-09-27,73,0,0,869.8700000000001,0.0,73
13980,2011-10-10,2011-10-10,60,0,0,200.14000000000001,0.0,60
13982,2010-12-09,2011-10-31,365,3,326,1871.81,109.0,39
13983,2010-12-08,2011-11-10,366,9,337,2603.43,37.0,29
13984,2010-12-08,2011-11-13,366,4,340,920.5100000000001,85.0,26
13985,2011-03-20,2011-12-05,264,14,260,7060.130000000006,19.0,4
13986,2011-11-22,2011-11-22,17,0,0,320.46000000000004,0.0,17
13988,2011-03-30,2011-11-20,254,5,235,4147.960000000001,47.0,19
13989,2011-04-14,2011-10-05,239,1,174,1266.0799999999997,174.0,65
13990,2011-05-10,2011-05-10,213,0,0,311.3,0.0,213
13991,2011-07-19,2011-11-27,143,4,131,855.9699999999999,33.0,12
13992,2011-11-09,2011-11-09,30,0,0,76.8,0.0,30
13993,2011-01-13,2011-10-28,330,8,288,3466.36,36.0,42
13994,2011-07-14,2011-12-06,148,5,145,2313.140000000001,29.0,3
13995,2011-04-08,2011-11-24,245,4,230,1393.6899999999996,58.0,15
13999,2010-12-13,2011-11-29,361,11,351,3901.8100000000036,32.0,10
14000,2011-05-12,2011-05-12,211,0,0,635.6600000000001,0.0,211
14001,2010-12-01,2011-10-25,373,2,328,2043.0800000000002,164.0,45
14002,2011-07-06,2011-07-28,156,1,22,529.73,22.0,134
14004,2011-02-24,2011-10-27,288,6,245,4582.639999999999,41.0,43
14005,2011-05-08,2011-11-30,215,4,206,2874.7200000000007,52.0,9
14006,2011-01-31,2011-08-16,312,2,197,962.1899999999999,98.0,115
14009,2011-05-18,2011-05-25,205,1,7,695.6099999999999,7.0,198
14012,2011-03-07,2011-03-07,277,0,0,328.8,0.0,277
14013,2011-03-09,2011-08-21,275,2,165,473.02,82.0,110
14014,2011-09-23,2011-09-23,77,0,0,505.18000000000006,0.0,77
14015,2011-10-18,2011-10-18,52,0,0,917.34,0.0,52
14016,2010-12-17,2011-07-01,357,3,196,4341.209999999999,65.0,161
14019,2011-07-24,2011-10-24,138,2,92,1421.6100000000004,46.0,46
14020,2011-09-12,2011-11-23,88,1,72,642.8000000000001,72.0,16
14021,2011-03-28,2011-07-07,256,2,101,631.9000000000001,50.0,155
14022,2011-04-28,2011-04-28,225,0,0,440.0,0.0,225
14023,2011-04-03,2011-12-02,250,1,243,584.0699999999999,243.0,7
14024,2011-08-07,2011-08-10,124,1,3,327.7,3.0,121
14027,2011-10-10,2011-10-10,60,0,0,104.82000000000002,0.0,60
14029,2011-07-18,2011-10-07,144,1,81,467.66,81.0,63
14030,2010-12-08,2011-11-21,366,6,348,2360.0899999999997,58.0,18
14031,2010-12-02,2011-12-02,372,16,365,17286.859999999997,23.0,7
14032,2010-12-08,2011-12-07,366,10,364,2975.5900000000006,36.0,2
14034,2011-07-05,2011-11-17,157,1,135,651.8200000000002,135.0,22
14035,2011-02-15,2011-11-11,297,4,269,1428.0200000000002,67.0,28
14036,2011-02-28,2011-02-28,284,0,0,626.6499999999999,0.0,284
14037,2010-12-10,2011-06-16,364,1,188,147.20000000000005,188.0,176
14038,2011-05-16,2011-09-22,207,2,129,1560.379999999999,64.0,78
14039,2011-11-06,2011-11-06,33,0,0,152.2,0.0,33
14040,2011-01-12,2011-10-30,331,10,291,3614.9199999999996,29.0,40
14041,2011-03-18,2011-03-18,266,0,0,141.41,0.0,266
14044,2011-02-03,2011-11-13,309,3,283,652.8199999999993,94.0,26
14045,2010-12-01,2011-08-22,373,2,264,1659.75,132.0,109
14046,2011-02-28,2011-02-28,284,0,0,154.98999999999998,0.0,284
14047,2010-12-02,2011-12-01,372,4,364,1308.61,91.0,8
14048,2011-02-07,2011-02-07,305,0,0,409.9299999999999,0.0,305
14049,2011-01-26,2011-11-23,317,3,301,5681.719999999997,100.0,16
14050,2011-08-25,2011-11-08,106,1,75,746.3600000000002,75.0,31
14051,2010-12-08,2011-12-09,366,21,366,15610.389999999989,17.0,0
14052,2011-11-20,2011-11-20,19,0,0,225.35999999999993,0.0,19
14053,2011-07-03,2011-08-07,159,1,35,260.25,35.0,124
14054,2011-10-05,2011-10-05,65,0,0,92.46000000000001,0.0,65
14055,2011-08-25,2011-08-25,106,0,0,725.6400000000001,0.0,106
14056,2011-02-28,2011-12-08,284,22,283,8214.64999999998,13.0,1
14057,2010-12-14,2011-11-16,360,13,337,6217.960000000002,26.0,23
14059,2011-03-18,2011-03-18,266,0,0,183.59999999999997,0.0,266
14060,2010-12-02,2011-12-05,372,18,368,6140.419999999998,20.0,4
14062,2010-12-10,2011-11-30,364,10,355,10464.85,36.0,9
14064,2011-03-10,2011-11-10,274,4,245,1353.7400000000002,61.0,29
14066,2011-03-18,2011-03-18,266,0,0,152.55,0.0,266
14067,2011-09-04,2011-10-07,96,1,33,374.69999999999993,33.0,63
14068,2011-01-23,2011-01-23,320,0,0,265.85,0.0,320
14071,2011-03-20,2011-12-06,264,6,261,1438.820000000003,44.0,3
14073,2011-11-07,2011-11-07,32,0,0,151.04,0.0,32
14075,2011-03-23,2011-12-05,261,2,257,942.2599999999998,128.0,4
14076,2011-08-02,2011-08-02,129,0,0,122.46999999999997,0.0,129
14077,2011-03-10,2011-10-30,274,4,234,499.41999999999996,58.0,40
14078,2010-12-01,2011-08-30,373,5,272,1049.3700000000001,54.0,101
14079,2011-08-07,2011-08-07,124,0,0,375.09999999999997,0.0,124
14080,2011-11-07,2011-11-07,32,0,0,45.599999999999994,0.0,32
14081,2010-12-05,2011-02-10,369,1,67,934.5200000000001,67.0,302
14082,2010-12-10,2010-12-10,364,0,0,182.24999999999997,0.0,364
14083,2010-12-03,2011-12-05,371,7,367,1018.4299999999998,52.0,4
14085,2010-12-06,2011-12-07,368,15,366,4448.539999999997,24.0,2
14087,2011-12-07,2011-12-07,2,0,0,194.42,0.0,2
14088,2011-01-21,2011-11-29,322,11,312,50491.81,28.0,10
14089,2011-10-14,2011-10-14,56,0,0,161.0,0.0,56
14090,2011-01-19,2011-01-19,324,0,0,76.32000000000002,0.0,324
14092,2010-12-16,2011-12-02,358,11,351,4076.910000000003,32.0,7
14093,2011-11-27,2011-11-27,12,0,0,442.8499999999999,0.0,12
14096,2011-08-30,2011-12-05,101,16,97,65164.78999999966,6.0,4
14098,2011-11-03,2011-11-03,36,0,0,147.34999999999997,0.0,36
14099,2010-12-20,2011-11-23,354,10,338,3104.1700000000005,34.0,16
14100,2011-07-25,2011-07-25,137,0,0,194.9,0.0,137
14101,2011-01-17,2011-09-27,326,5,253,5976.79,51.0,73
14102,2011-10-26,2011-12-04,44,4,39,1360.2800000000002,10.0,5
14104,2011-06-27,2011-07-08,165,1,11,216.21,11.0,154
14105,2011-04-14,2011-04-14,239,0,0,1266.2300000000002,0.0,239
14107,2010-12-10,2011-10-19,364,6,313,2703.2300000000005,52.0,51
14108,2011-08-30,2011-11-09,101,1,71,597.9100000000001,71.0,30
14109,2011-09-28,2011-09-28,72,0,0,144.20000000000002,0.0,72
14110,2011-03-18,2011-12-06,266,11,263,5683.15,24.0,3
14111,2011-04-12,2011-11-25,241,3,227,692.85,76.0,14
14112,2011-03-09,2011-11-17,275,4,253,2915.1499999999974,63.0,22
14113,2010-12-20,2011-12-06,354,3,351,1840.4200000000005,117.0,3
14114,2011-01-13,2011-03-11,330,1,57,386.5299999999999,57.0,273
14116,2011-08-10,2011-11-20,121,4,102,1382.7400000000002,26.0,19
14117,2011-07-19,2011-07-19,143,0,0,90.0,0.0,143
14121,2011-10-11,2011-12-06,59,3,56,2780.1499999999996,19.0,3
14124,2011-09-16,2011-09-16,84,0,0,419.58,0.0,84
14125,2011-09-22,2011-11-29,78,2,68,2740.4300000000017,34.0,10
14126,2011-11-29,2011-12-02,10,1,3,706.1300000000001,3.0,7
14127,2011-02-02,2011-08-09,310,2,188,709.7099999999996,94.0,122
14128,2011-03-29,2011-10-10,255,1,195,637.5000000000001,195.0,60
14129,2011-03-24,2011-12-08,260,3,259,1123.86,86.0,1
14130,2011-01-24,2011-01-24,319,0,0,483.85999999999996,0.0,319
14132,2011-06-09,2011-12-07,183,10,181,3586.030000000001,18.0,2
14133,2011-01-28,2011-08-02,315,1,186,605.6399999999999,186.0,129
14135,2010-12-02,2011-12-08,372,13,371,4690.31,29.0,1
14138,2011-10-07,2011-12-08,63,1,62,982.3800000000005,62.0,1
14139,2011-10-24,2011-10-24,46,0,0,415.81999999999994,0.0,46
14140,2011-11-08,2011-12-06,31,1,28,935.0499999999996,28.0,3
14141,2011-08-26,2011-12-07,105,3,103,915.1300000000003,34.0,2
14142,2010-12-01,2010-12-01,373,0,0,311.81000000000006,0.0,373
14143,2011-07-29,2011-07-29,133,0,0,115.8,0.0,133
14145,2011-05-06,2011-10-24,217,3,171,3742.2,57.0,46
14146,2010-12-17,2011-12-01,357,3,349,4190.999999999999,116.0,8
14147,2011-02-27,2011-09-22,285,1,207,483.4,207.0,78
14148,2011-04-20,2011-04-20,233,0,0,157.2,0.0,233
14149,2011-05-03,2011-05-03,220,0,0,446.6200000000001,0.0,220
14150,2010-12-15,2011-11-04,359,1,324,658.6400000000001,324.0,35
14152,2011-04-19,2011-09-25,234,1,159,621.2900000000002,159.0,75
14154,2011-04-14,2011-04-14,239,0,0,1345.6200000000001,0.0,239
14155,2011-03-18,2011-03-18,266,0,0,118.75,0.0,266
14156,2010-12-03,2011-11-30,371,42,362,117379.6299999998,9.0,9
14157,2011-02-27,2011-11-20,285,1,266,432.8800000000002,266.0,19
14158,2011-10-30,2011-10-30,40,0,0,507.66000000000014,0.0,40
14159,2010-12-12,2011-11-20,362,10,343,4693.00999999999,34.0,19
14161,2010-12-05,2011-05-08,369,2,154,1110.52,77.0,215
14162,2011-02-20,2011-06-19,292,1,119,289.36000000000007,119.0,173
14163,2011-04-14,2011-09-13,239,3,152,2445.9100000000008,51.0,87
14164,2011-09-20,2011-09-30,80,1,10,1631.7700000000002,10.0,70
14165,2011-03-09,2011-03-09,275,0,0,122.53999999999999,0.0,275
14167,2011-01-12,2011-10-31,331,3,292,574.8399999999999,97.0,39
14171,2011-09-02,2011-09-02,98,0,0,363.79,0.0,98
14173,2011-05-04,2011-11-29,219,2,209,450.84000000000003,104.0,10
14174,2011-11-06,2011-11-06,33,0,0,134.46,0.0,33
14175,2011-01-14,2011-10-11,329,2,270,3222.300000000001,135.0,59
14176,2010-12-07,2011-02-15,367,2,70,576.9,35.0,297
14177,2011-06-13,2011-09-14,179,2,93,559.4100000000001,46.0,86
14178,2011-06-10,2011-12-01,182,6,174,1620.93,29.0,8
14179,2011-10-18,2011-10-30,52,1,12,719.7799999999997,12.0,40
14180,2010-12-02,2011-11-29,372,23,362,4748.519999999998,16.0,10
14184,2011-10-04,2011-10-04,66,0,0,452.89,0.0,66
14185,2011-01-12,2011-01-12,331,0,0,197.65,0.0,331
14188,2011-02-02,2011-11-09,310,5,280,2054.3599999999997,56.0,30
14189,2010-12-06,2011-12-07,368,13,366,4654.079999999999,28.0,2
14191,2011-05-03,2011-12-08,220,12,219,4684.760000000001,18.0,1
14193,2011-03-15,2011-10-03,269,1,202,853.3900000000002,202.0,67
14194,2011-02-04,2011-12-05,308,14,304,11349.519999999986,22.0,4
14195,2011-04-01,2011-05-22,252,1,51,1011.9999999999998,51.0,201
14196,2011-08-25,2011-08-25,106,0,0,335.52,0.0,106
14198,2011-04-14,2011-11-21,239,3,221,701.3999999999999,74.0,18
14199,2011-05-05,2011-05-05,218,0,0,185.39999999999998,0.0,218
14201,2010-12-15,2011-10-10,359,6,299,747.44,50.0,60
14204,2011-12-07,2011-12-07,2,0,0,161.02999999999994,0.0,2
14205,2011-03-20,2011-11-23,264,1,248,466.70000000000005,248.0,16
14206,2011-04-14,2011-04-14,239,0,0,328.1599999999999,0.0,239
14208,2011-09-06,2011-09-06,94,0,0,151.73999999999998,0.0,94
14209,2011-01-11,2011-11-29,332,5,322,2073.4300000000003,64.0,10
14210,2010-12-03,2011-08-26,371,5,266,1905.8400000000004,53.0,105
14211,2011-02-17,2011-10-17,295,8,242,2241.1000000000004,30.0,53
14212,2011-09-11,2011-09-11,89,0,0,1070.48,0.0,89
14214,2011-03-07,2011-11-09,277,4,247,1004.3799999999997,62.0,30
14215,2010-12-06,2011-11-28,368,5,357,1789.7200000000007,71.0,11
14216,2011-11-02,2011-12-06,37,3,34,1839.3,11.0,3
14217,2010-12-08,2011-12-08,366,15,365,2004.9800000000002,24.0,1
14218,2011-10-28,2011-10-28,42,0,0,169.48000000000002,0.0,42
14219,2011-12-05,2011-12-05,4,0,0,89.94,0.0,4
14220,2010-12-16,2011-04-06,358,1,111,632.4,111.0,247
14221,2011-01-04,2011-10-28,339,6,297,3432.7999999999993,50.0,42
14222,2011-06-15,2011-06-15,177,0,0,683.17,0.0,177
14223,2011-03-20,2011-09-08,264,2,172,991.13,86.0,92
14224,2011-01-23,2011-08-21,320,3,210,1050.1200000000001,70.0,110
14226,2011-03-15,2011-11-11,269,4,241,2232.19,60.0,28
14227,2011-02-28,2011-11-13,284,5,258,3350.9600000000014,52.0,26
14229,2011-01-10,2011-10-19,333,2,282,1547.2,141.0,51
14231,2011-02-24,2011-06-09,288,2,105,925.71,52.0,183
14232,2011-03-20,2011-10-28,264,4,222,2048.0700000000006,56.0,42
14233,2011-01-26,2011-10-21,317,3,268,1462.7200000000007,89.0,49
14234,2011-10-13,2011-11-17,57,3,35,775.4600000000004,12.0,22
14235,2011-03-24,2011-09-25,260,3,185,3144.8599999999997,62.0,75
14236,2010-12-02,2011-09-20,372,1,292,490.86,292.0,80
14237,2010-12-01,2010-12-01,373,0,0,161.00000000000003,0.0,373
14238,2011-01-17,2011-01-17,326,0,0,146.85,0.0,326
14239,2011-01-27,2011-10-27,316,10,273,2380.8500000000017,27.0,43
14240,2011-04-28,2011-11-09,225,1,195,890.3400000000005,195.0,30
14241,2011-06-09,2011-06-09,183,0,0,213.70000000000002,0.0,183
14242,2011-01-18,2011-04-19,325,1,91,280.55,91.0,234
14243,2010-12-09,2011-12-01,365,9,357,2588.769999999999,40.0,8
14245,2011-03-21,2011-05-04,263,1,44,1693.4499999999996,44.0,219
14246,2011-04-08,2011-08-21,245,2,135,1474.0600000000006,68.0,110
14247,2011-03-06,2011-03-06,278,0,0,136.76999999999998,0.0,278
14248,2011-01-25,2011-01-25,318,0,0,302.58,0.0,318
14250,2011-09-11,2011-12-02,89,1,82,1904.0500000000002,82.0,7
14251,2011-10-13,2011-12-08,57,4,56,2879.7000000000003,14.0,1
14256,2010-12-10,2011-03-24,364,1,104,969.06,104.0,260
14257,2011-01-25,2011-10-06,318,4,254,3099.72,64.0,64
14258,2011-01-06,2011-11-30,337,7,328,12669.979999999996,47.0,9
14259,2011-07-21,2011-07-21,141,0,0,120.0,0.0,141
14261,2011-09-22,2011-10-20,78,1,28,1163.45,28.0,50
14262,2011-04-13,2011-12-01,240,7,232,2618.230000000001,33.0,8
14264,2011-04-08,2011-07-08,245,1,91,333.9700000000001,91.0,154
14265,2011-07-14,2011-08-22,148,1,39,530.18,39.0,109
14267,2011-03-24,2011-06-30,260,1,98,1516.2399999999998,98.0,162
14270,2011-01-12,2011-01-12,331,0,0,492.6499999999999,0.0,331
14271,2011-04-28,2011-04-28,225,0,0,112.32000000000002,0.0,225
14272,2011-03-30,2011-09-27,254,1,181,437.96000000000004,181.0,73
14273,2011-04-11,2011-10-19,242,3,191,559.9700000000001,64.0,51
14276,2011-02-23,2011-09-02,289,2,191,1119.7399999999998,96.0,98
14277,2011-05-11,2011-11-24,212,2,197,4216.200000000001,98.0,15
14280,2011-05-27,2011-05-27,196,0,0,134.04,0.0,196
14282,2010-12-07,2011-12-06,367,14,364,3729.3400000000042,26.0,3
14284,2011-09-14,2011-11-09,86,1,56,595.2500000000001,56.0,30
14285,2011-06-16,2011-11-18,176,3,155,1910.0100000000004,52.0,21
14286,2011-04-11,2011-11-16,242,2,219,4628.749999999998,110.0,23
14287,2011-05-25,2011-12-01,198,1,190,176.63,190.0,8
14288,2011-05-10,2011-05-10,213,0,0,426.6,0.0,213
14289,2011-02-23,2011-12-01,289,5,281,911.2599999999999,56.0,8
14290,2010-12-13,2011-11-28,361,4,350,2314.6499999999996,88.0,11
14291,2011-03-09,2011-12-08,275,6,274,3883.249999999998,46.0,1
14292,2011-03-02,2011-12-02,282,5,275,4871.9299999999985,55.0,7
14293,2010-12-06,2011-12-06,368,3,365,1046.5599999999995,122.0,3
14295,2011-10-30,2011-10-30,40,0,0,166.20000000000005,0.0,40
14297,2011-03-10,2011-11-22,274,3,257,1305.3299999999997,86.0,17
14298,2010-12-14,2011-12-01,360,24,352,51527.299999999974,15.0,8
14299,2010-12-09,2011-12-01,365,8,357,3965.619999999996,45.0,8
14300,2011-11-21,2011-11-21,18,0,0,43.2,0.0,18
14301,2011-08-14,2011-08-14,117,0,0,640.1400000000001,0.0,117
14304,2011-05-01,2011-05-01,222,0,0,383.45000000000005,0.0,222
14305,2011-07-27,2011-09-29,135,2,64,1858.9599999999998,32.0,71
14306,2011-09-15,2011-10-19,85,1,34,2093.3199999999997,34.0,51
14307,2010-12-01,2011-09-12,373,4,285,2995.7200000000007,71.0,88
14309,2010-12-16,2011-12-01,358,8,350,2352.530000000001,44.0,8
14311,2011-04-11,2011-04-11,242,0,0,310.26,0.0,242
14312,2011-01-06,2011-10-24,337,5,291,1611.5899999999997,58.0,46
14314,2011-08-25,2011-08-25,106,0,0,120.0,0.0,106
14315,2011-03-18,2011-10-26,266,5,222,2481.1299999999997,44.0,44
14317,2011-10-06,2011-10-06,64,0,0,508.58,0.0,64
14320,2011-01-11,2011-05-17,332,1,126,477.7900000000001,126.0,206
14321,2011-01-10,2011-11-29,333,4,323,1530.749999999999,81.0,10
14323,2011-04-15,2011-08-17,238,1,124,605.0600000000002,124.0,114
14326,2011-04-11,2011-04-11,242,0,0,183.85000000000002,0.0,242
14327,2011-06-29,2011-06-29,163,0,0,311.65000000000003,0.0,163
14329,2011-01-14,2011-11-22,329,5,312,5014.840000000004,62.0,17
14331,2011-07-27,2011-08-07,135,1,11,462.65999999999997,11.0,124
14332,2011-07-15,2011-11-17,147,2,125,866.31,62.0,22
14333,2011-10-03,2011-10-03,67,0,0,415.2,0.0,67
14334,2010-12-16,2011-11-23,358,7,342,2552.2100000000005,49.0,16
14335,2011-09-04,2011-11-23,96,1,80,468.26,80.0,16
14336,2011-03-08,2011-11-23,276,3,260,1614.9100000000008,87.0,16
14338,2011-05-27,2011-07-01,196,1,35,588.2199999999999,35.0,161
14339,2011-04-11,2011-04-11,242,0,0,309.52,0.0,242
14340,2011-05-05,2011-05-05,218,0,0,134.70000000000002,0.0,218
14341,2011-01-25,2011-10-25,318,4,273,2182.2799999999984,68.0,45
14342,2011-05-13,2011-11-18,210,3,189,668.5600000000002,63.0,21
14344,2010-12-06,2011-08-04,368,7,241,889.9300000000002,34.0,127
14345,2011-11-01,2011-11-01,38,0,0,108.98000000000002,0.0,38
14346,2011-02-15,2011-08-11,297,1,177,1021.5800000000002,177.0,120
14348,2011-03-24,2011-03-24,260,0,0,409.57,0.0,260
14349,2011-11-29,2011-11-29,10,0,0,133.50000000000006,0.0,10
14350,2011-03-10,2011-03-10,274,0,0,282.92999999999995,0.0,274
14351,2011-06-28,2011-06-28,164,0,0,51.0,0.0,164
14352,2011-03-11,2011-07-05,273,2,116,1078.9600000000003,58.0,157
14353,2011-05-08,2011-05-08,215,0,0,90.6,0.0,215
14354,2011-11-09,2011-12-04,30,1,25,163.62,25.0,5
14355,2010-12-09,2010-12-09,365,0,0,174.4,0.0,365
14356,2011-09-19,2011-09-21,81,1,2,701.23,2.0,79
14357,2011-10-27,2011-10-27,43,0,0,225.77000000000012,0.0,43
14359,2011-09-13,2011-11-20,87,2,68,912.1800000000002,34.0,19
14360,2011-09-06,2011-11-08,94,2,63,2128.23,32.0,31
14362,2011-11-17,2011-11-17,22,0,0,161.20000000000002,0.0,22
14364,2011-05-12,2011-08-23,211,6,103,3717.349999999999,17.0,108
14367,2011-03-08,2011-12-01,276,12,268,9261.520000000006,22.0,8
14368,2011-01-24,2011-01-24,319,0,0,155.00000000000003,0.0,319
14371,2011-02-17,2011-02-17,295,0,0,100.5,0.0,295
14373,2010-12-16,2010-12-16,358,0,0,76.55,0.0,358
14375,2011-06-07,2011-06-07,185,0,0,257.67999999999995,0.0,185
14377,2011-03-22,2011-06-01,262,1,71,617.05,71.0,191
14379,2011-02-17,2011-10-26,295,1,251,348.1,251.0,44
14381,2011-10-18,2011-10-18,52,0,0,202.6800000000001,0.0,52
14382,2011-11-13,2011-11-13,26,0,0,626.07,0.0,26
14383,2011-06-29,2011-11-01,163,2,125,1247.6899999999998,62.0,38
14385,2011-11-16,2011-11-30,23,2,14,202.11,7.0,9
14386,2011-02-16,2011-02-16,296,0,0,142.4,0.0,296
14387,2011-08-22,2011-11-07,109,2,77,1770.5600000000013,38.0,32
14388,2010-12-02,2011-11-29,372,7,362,3212.8400000000015,52.0,10
14389,2011-06-02,2011-10-05,190,1,125,1043.46,125.0,65
14390,2010-12-02,2011-11-29,372,7,362,4652.8200000000015,52.0,10
14393,2011-05-05,2011-05-05,218,0,0,67.94999999999999,0.0,218
14395,2010-12-02,2011-12-07,372,8,370,3507.710000000001,46.0,2
14396,2010-12-03,2011-10-05,371,1,306,487.99,306.0,65
14397,2011-05-10,2011-12-07,213,18,211,2612.960000000001,12.0,2
14400,2011-07-13,2011-07-13,149,0,0,574.7,0.0,149
14401,2010-12-15,2011-12-05,359,12,355,4051.4799999999987,30.0,4
14403,2011-04-06,2011-08-01,247,3,117,1475.8100000000002,39.0,130
14404,2010-12-05,2011-11-06,369,5,336,1474.3200000000004,67.0,33
14406,2011-08-12,2011-08-12,119,0,0,156.75000000000003,0.0,119
14407,2011-03-08,2011-08-24,276,5,169,2157.7299999999996,34.0,107
14408,2011-03-20,2011-11-29,264,6,254,2606.5300000000007,42.0,10
14409,2010-12-06,2011-09-29,368,4,297,2059.45,74.0,71
14410,2011-02-07,2011-09-08,305,6,213,1105.0699999999986,36.0,92
14411,2011-02-02,2011-02-02,310,0,0,1063.0,0.0,310
14412,2011-09-28,2011-10-28,72,1,30,770.0300000000002,30.0,42
14413,2010-12-12,2010-12-12,362,0,0,122.70000000000002,0.0,362
14414,2010-12-16,2011-09-09,358,6,267,1496.9800000000005,44.0,91
14415,2010-12-14,2011-12-08,360,12,359,5900.279999999999,30.0,1
14416,2011-10-28,2011-11-17,42,1,20,490.22,20.0,22
14418,2011-08-23,2011-12-06,108,2,105,1937.2500000000002,52.0,3
14419,2010-12-10,2011-11-29,364,5,354,1058.0600000000002,71.0,10
14420,2011-09-01,2011-09-01,99,0,0,387.52,0.0,99
14421,2011-05-12,2011-10-13,211,1,154,813.11,154.0,57
14422,2011-03-17,2011-12-09,267,5,267,4263.64,53.0,0
14423,2011-05-05,2011-05-05,218,0,0,265.2,0.0,218
14424,2011-11-22,2011-11-22,17,0,0,322.08,0.0,17
14426,2011-01-31,2011-11-16,312,6,289,4481.670000000001,48.0,23
14427,2011-10-07,2011-10-20,63,1,13,363.34000000000003,13.0,50
14428,2011-01-18,2011-12-02,325,4,318,1244.8300000000004,80.0,7
14431,2011-02-10,2011-02-10,302,0,0,470.36000000000007,0.0,302
14432,2011-09-11,2011-11-30,89,5,80,2255.5099999999984,16.0,9
14434,2011-09-28,2011-11-18,72,5,51,1372.8,10.0,21
14436,2011-09-02,2011-09-02,98,0,0,89.06,0.0,98
14437,2010-12-09,2010-12-09,365,0,0,63.0,0.0,365
14438,2011-02-06,2011-02-06,306,0,0,131.9,0.0,306
14439,2011-01-24,2011-01-24,319,0,0,2661.24,0.0,319
14440,2010-12-09,2011-12-01,365,4,357,2357.6800000000003,89.0,8
14441,2011-03-29,2011-12-09,255,3,255,1712.8900000000008,85.0,0
14442,2011-01-27,2011-05-19,316,1,112,1589.8200000000002,112.0,204
14443,2010-12-06,2011-10-17,368,3,315,1420.2000000000005,105.0,53
14446,2011-04-07,2011-12-09,246,3,246,1039.5800000000008,82.0,0
14447,2011-03-04,2011-11-21,280,3,262,1163.2300000000005,87.0,18
14448,2010-12-10,2011-11-30,364,1,355,375.35,355.0,9
14449,2010-12-02,2011-11-21,372,3,354,907.0999999999999,118.0,18
14450,2011-01-23,2011-06-12,320,2,140,483.25,70.0,180
14451,2011-05-29,2011-10-10,194,1,134,662.5900000000001,134.0,60
14452,2011-09-07,2011-11-29,93,1,83,264.44000000000005,83.0,10
14453,2011-06-02,2011-06-02,190,0,0,119.93000000000002,0.0,190
14456,2011-07-20,2011-12-04,142,7,137,3062.3999999999983,20.0,5
14457,2011-02-02,2011-02-02,310,0,0,113.64,0.0,310
14459,2011-07-07,2011-07-07,155,0,0,1837.9199999999998,0.0,155
14460,2011-02-02,2011-08-21,310,2,200,434.34,100.0,110
14461,2011-03-23,2011-07-14,261,2,113,2103.059999999999,56.0,148
14462,2011-01-04,2011-10-04,339,8,273,2004.0200000000004,34.0,66
14463,2011-05-18,2011-09-02,205,2,107,529.62,54.0,98
14465,2011-02-10,2011-04-07,302,1,56,1058.6200000000008,56.0,246
14466,2010-12-02,2011-11-10,372,6,343,2272.4000000000015,57.0,29
14467,2011-01-31,2011-11-22,312,3,295,598.7599999999999,98.0,17
14470,2011-02-25,2011-11-28,287,1,276,461.19000000000005,276.0,11
14472,2010-12-19,2011-08-28,355,7,252,1936.8400000000013,36.0,103
14473,2011-03-02,2011-09-26,282,1,208,234.34000000000003,208.0,74
14474,2011-10-24,2011-10-24,46,0,0,547.6600000000001,0.0,46
14475,2011-02-08,2011-09-29,304,2,233,925.8499999999999,116.0,71
14476,2011-03-27,2011-03-27,257,0,0,215.7,0.0,257
14477,2011-02-15,2011-11-20,297,3,278,1309.6000000000001,93.0,19
14479,2010-12-09,2011-03-31,365,1,112,316.24999999999994,112.0,253
14480,2011-11-28,2011-11-28,11,0,0,279.05000000000007,0.0,11
14481,2011-02-25,2011-06-28,287,1,123,636.5100000000002,123.0,164
14482,2011-04-14,2011-11-21,239,5,221,2068.150000000001,44.0,18
14483,2011-03-03,2011-03-03,281,0,0,137.10000000000002,0.0,281
14484,2011-10-20,2011-10-20,50,0,0,321.91999999999996,0.0,50
14485,2011-11-01,2011-11-01,38,0,0,165.75000000000003,0.0,38
14487,2010-12-06,2011-11-13,368,4,342,1196.3300000000002,86.0,26
14488,2011-10-03,2011-10-03,67,0,0,1064.2800000000002,0.0,67
14489,2011-05-16,2011-05-16,207,0,0,463.38000000000005,0.0,207
14491,2010-12-02,2011-06-17,372,1,197,340.93,197.0,175
14493,2011-07-07,2011-12-02,155,4,148,2383.2400000000002,37.0,7
14494,2011-11-14,2011-11-14,25,0,0,139.56,0.0,25
14495,2011-08-10,2011-10-20,121,1,71,123.8,71.0,50
14496,2010-12-01,2011-02-01,373,1,62,538.8100000000001,62.0,311
14497,2011-02-03,2011-02-03,309,0,0,475.36999999999995,0.0,309
14498,2010-12-13,2011-10-28,361,4,319,1957.3200000000004,80.0,42
14499,2011-03-06,2011-11-13,278,2,252,815.32,126.0,26
14500,2011-06-03,2011-09-12,189,2,101,356.85,50.0,88
14501,2011-01-24,2011-06-09,319,1,136,251.20999999999998,136.0,183
14502,2011-01-30,2011-11-20,313,8,294,2470.6699999999996,37.0,19
14503,2011-06-14,2011-12-06,178,5,175,3543.2600000000016,35.0,3
14504,2011-03-06,2011-10-23,278,3,231,673.2599999999995,77.0,47
14505,2010-12-12,2011-11-22,362,7,345,5905.639999999987,49.0,17
14506,2010-12-05,2011-11-22,369,4,352,2012.1700000000014,88.0,17
14507,2011-03-08,2011-11-16,276,4,253,1383.1799999999992,63.0,23
14508,2011-09-11,2011-11-17,89,1,67,276.41999999999996,67.0,22
14511,2011-07-29,2011-11-28,133,4,122,1314.8099999999997,30.0,11
14512,2011-04-21,2011-06-05,232,1,45,275.28,45.0,187
14513,2011-02-24,2011-08-31,288,2,188,455.59000000000003,94.0,100
14514,2011-01-12,2011-10-09,331,2,270,1055.35,135.0,61
14515,2011-05-05,2011-11-22,218,4,201,2102.0899999999997,50.0,17
14517,2011-07-21,2011-11-06,141,1,108,330.45,108.0,33
14518,2011-10-06,2011-10-06,64,0,0,174.37,0.0,64
14520,2011-02-22,2011-12-08,290,1,289,270.6,289.0,1
14522,2011-05-25,2011-11-15,198,3,174,974.54,58.0,24
14523,2011-08-23,2011-08-23,108,0,0,241.09000000000003,0.0,108
14524,2010-12-14,2011-11-08,360,5,329,1867.6800000000007,66.0,31
14525,2010-12-13,2011-11-20,361,8,342,4332.199999999996,43.0,19
14527,2010-12-05,2011-12-07,369,53,367,8508.81999999996,7.0,2
14528,2011-11-02,2011-11-02,37,0,0,364.22,0.0,37
14529,2011-08-21,2011-10-10,110,2,50,620.0399999999998,25.0,60
14530,2011-02-16,2011-11-14,296,5,271,2925.910000000001,54.0,25
14532,2010-12-22,2011-04-17,352,3,116,932.8499999999997,39.0,236
14533,2010-12-22,2011-11-15,352,6,328,1949.7200000000007,55.0,24
14534,2011-01-25,2011-12-07,318,17,316,4447.049999999999,19.0,2
14535,2011-04-05,2011-10-10,248,2,188,2864.190000000005,94.0,60
14536,2011-03-25,2011-03-25,259,0,0,171.8,0.0,259
14537,2011-10-13,2011-10-13,57,0,0,355.56000000000006,0.0,57
14538,2011-03-28,2011-10-06,256,1,192,388.24999999999994,192.0,64
14539,2011-10-26,2011-11-24,44,1,29,537.48,29.0,15
14540,2011-02-03,2011-11-30,309,2,300,996.26,150.0,9
14541,2011-01-24,2011-10-12,319,6,261,1461.6499999999999,44.0,58
14542,2011-06-07,2011-06-07,185,0,0,103.25000000000001,0.0,185
14543,2010-12-10,2011-11-11,364,14,336,3630.3300000000013,24.0,28
14544,2010-12-13,2011-11-15,361,1,337,2024.4500000000007,337.0,24
14546,2011-04-05,2011-12-04,248,4,243,2578.0900000000024,61.0,5
14547,2011-10-16,2011-12-06,54,7,51,4007.539999999999,7.0,3
14548,2011-01-26,2011-07-12,317,1,167,652.8,167.0,150
14549,2011-02-01,2011-02-01,311,0,0,289.23999999999995,0.0,311
14550,2011-10-26,2011-11-29,44,1,34,765.6200000000001,34.0,10
14551,2011-05-19,2011-11-21,204,1,186,186.23000000000002,186.0,18
14552,2011-07-11,2011-07-11,151,0,0,165.07000000000005,0.0,151
14553,2011-01-04,2011-11-20,339,3,320,859.27,107.0,19
14554,2011-10-18,2011-11-29,52,3,42,2381.040000000002,14.0,10
14555,2011-02-10,2011-10-13,302,1,245,324.14000000000004,245.0,57
14557,2011-09-15,2011-09-15,85,0,0,788.3800000000001,0.0,85
14560,2010-12-17,2011-12-02,357,19,350,2237.7700000000013,18.0,7
14561,2011-06-08,2011-09-25,184,2,109,1080.7600000000004,54.0,75
14562,2011-02-08,2011-12-06,304,16,301,5074.769999999998,19.0,3
14565,2010-12-13,2011-09-05,361,3,266,3099.1200000000017,89.0,95
14566,2011-08-21,2011-08-21,110,0,0,1432.0,0.0,110
14567,2011-08-01,2011-10-14,130,1,74,1530.3600000000006,74.0,56
14569,2011-12-08,2011-12-08,1,0,0,227.39,0.0,1
14570,2011-03-04,2011-03-04,280,0,0,218.05999999999992,0.0,280
14572,2011-01-19,2011-12-06,324,6,321,2832.840000000001,54.0,3
14573,2010-12-02,2011-06-13,372,7,193,1653.4200000000017,28.0,179
14576,2010-12-02,2010-12-02,372,0,0,35.40000000000001,0.0,372
14577,2010-12-12,2011-11-27,362,3,350,859.7100000000011,117.0,12
14578,2011-12-06,2011-12-06,3,0,0,168.63,0.0,3
14581,2011-11-23,2011-11-23,16,0,0,138.6,0.0,16
14582,2011-10-30,2011-10-30,40,0,0,114.11000000000001,0.0,40
14583,2011-05-18,2011-12-04,205,4,200,1052.5500000000004,50.0,5
14584,2011-05-25,2011-06-23,198,3,29,1042.2599999999995,10.0,169
14585,2011-10-20,2011-10-20,50,0,0,157.05,0.0,50
14586,2011-03-08,2011-03-08,276,0,0,237.35999999999996,0.0,276
14587,2011-01-12,2011-11-21,331,8,313,1601.1400000000008,39.0,18
14589,2010-12-03,2010-12-03,371,0,0,39.75,0.0,371
14591,2011-05-10,2011-11-24,213,1,198,1447.140000000001,198.0,15
14592,2011-10-06,2011-11-04,64,2,29,570.4599999999998,14.0,35
14593,2011-05-25,2011-11-18,198,1,177,617.9900000000001,177.0,21
14594,2010-12-01,2011-12-02,373,1,366,379.82999999999987,366.0,7
14595,2011-01-30,2011-11-20,313,5,294,1740.6000000000001,59.0,19
14597,2011-06-01,2011-11-28,191,1,180,883.1500000000001,180.0,11
14598,2011-10-26,2011-10-26,44,0,0,221.97000000000003,0.0,44
14600,2011-02-07,2011-02-07,305,0,0,393.3299999999999,0.0,305
14601,2011-11-29,2011-11-29,10,0,0,213.96000000000004,0.0,10
14603,2011-03-10,2011-03-10,274,0,0,660.0,0.0,274
14606,2010-12-01,2011-12-08,373,88,372,12156.65000000007,4.0,1
14607,2011-03-23,2011-11-24,261,6,246,16569.5,41.0,15
14608,2010-12-12,2011-12-05,362,3,358,1785.1499999999999,119.0,4
14609,2011-02-16,2011-09-28,296,3,224,601.5600000000001,75.0,72
14616,2011-01-26,2011-04-11,317,2,75,406.08000000000004,38.0,242
14618,2011-01-06,2011-11-30,337,2,328,553.44,164.0,9
14619,2011-04-08,2011-04-08,245,0,0,394.44000000000005,0.0,245
14620,2011-03-01,2011-05-18,283,1,78,412.78,78.0,205
14621,2010-12-16,2011-12-08,358,4,357,1788.36,89.0,1
14622,2011-06-08,2011-06-08,184,0,0,320.58,0.0,184
14623,2011-04-18,2011-11-07,235,4,203,889.2499999999999,51.0,32
14624,2011-10-11,2011-10-13,59,1,2,225.85000000000002,2.0,57
14625,2010-12-13,2011-05-27,361,1,165,899.6300000000001,165.0,196
14626,2011-04-20,2011-11-16,233,3,210,2791.2699999999995,70.0,23
14628,2011-04-11,2011-09-09,242,1,151,671.9600000000002,151.0,91
14629,2011-10-23,2011-12-05,47,1,43,959.0100000000001,43.0,4
14631,2011-02-14,2011-10-20,298,2,248,1006.9799999999999,124.0,50
14632,2011-03-22,2011-03-22,262,0,0,114.55999999999999,0.0,262
14633,2011-03-18,2011-03-18,266,0,0,344.90000000000015,0.0,266
14636,2011-03-16,2011-11-03,268,1,232,609.8500000000003,232.0,36
14638,2011-10-20,2011-10-20,50,0,0,443.6,0.0,50
14639,2010-12-13,2011-10-18,361,3,309,2984.4900000000025,103.0,52
14640,2011-04-26,2011-11-15,227,5,203,2125.079999999999,41.0,24
14641,2011-11-18,2011-11-18,21,0,0,110.46000000000001,0.0,21
14642,2011-10-12,2011-10-12,58,0,0,96.12000000000002,0.0,58
14643,2010-12-16,2011-06-22,358,1,188,693.8100000000001,188.0,170
14644,2011-02-14,2011-10-03,298,1,231,830.76,231.0,67
14645,2011-03-09,2011-07-06,275,1,119,597.09,119.0,156
14646,2010-12-20,2011-12-08,354,44,353,280206.01999999984,8.0,1
14647,2011-05-22,2011-05-22,201,0,0,243.21999999999994,0.0,201
14649,2011-05-11,2011-12-05,212,2,208,1417.2899999999997,104.0,4
14651,2011-05-12,2011-10-03,211,1,144,654.5999999999998,144.0,67
14652,2011-09-23,2011-09-23,77,0,0,114.18000000000002,0.0,77
14653,2011-01-05,2011-12-08,338,5,337,1947.5499999999997,67.0,1
14655,2011-05-01,2011-12-01,222,3,214,1932.23,71.0,8
14656,2011-03-01,2011-06-23,283,1,114,291.04999999999984,114.0,169
14657,2011-01-17,2011-11-22,326,3,309,848.22,103.0,17
14658,2011-08-14,2011-12-04,117,1,112,247.14999999999998,112.0,5
14659,2011-01-28,2011-12-01,315,8,307,2529.930000000001,38.0,8
14660,2011-08-31,2011-09-14,100,1,14,285.73999999999995,14.0,86
14661,2011-11-13,2011-11-13,26,0,0,107.95,0.0,26
14662,2011-01-27,2011-11-11,316,3,288,771.1700000000003,96.0,28
14664,2011-11-06,2011-11-20,33,1,14,637.89,14.0,19
14665,2011-02-02,2011-10-10,310,3,250,1835.7000000000003,83.0,60
14666,2011-11-15,2011-11-15,24,0,0,195.24999999999997,0.0,24
14667,2010-12-06,2011-11-29,368,22,358,9241.200000000004,16.0,10
14669,2011-01-11,2011-04-12,332,1,91,1269.9900000000002,91.0,241
14670,2011-03-04,2011-03-04,280,0,0,411.5300000000001,0.0,280
14672,2011-01-07,2011-04-19,336,1,102,765.5500000000001,102.0,234
14673,2010-12-07,2011-12-06,367,4,364,1736.3999999999996,91.0,3
14675,2011-11-23,2011-11-23,16,0,0,604.7499999999999,0.0,16
14676,2011-03-01,2011-11-08,283,5,252,2548.24,50.0,31
14680,2010-12-03,2011-11-14,371,15,346,28754.110000000004,23.0,25
14681,2011-05-12,2011-09-29,211,1,140,498.95,140.0,71
14682,2011-05-22,2011-06-05,201,1,14,52.000000000000014,14.0,187
14684,2010-12-12,2011-11-14,362,4,337,1236.2800000000013,84.0,25
14687,2011-08-25,2011-08-25,106,0,0,628.38,0.0,106
14688,2010-12-01,2011-12-02,373,19,366,5630.869999999997,19.0,7
14689,2011-05-15,2011-05-15,208,0,0,112.8,0.0,208
14690,2011-07-11,2011-10-26,151,1,107,371.7,107.0,44
14691,2011-05-11,2011-11-09,212,3,182,2114.3299999999995,61.0,30
14692,2011-01-21,2011-07-25,322,3,185,591.5500000000001,62.0,137
14693,2011-03-20,2011-03-20,264,0,0,172.9,0.0,264
14696,2010-12-01,2011-12-05,373,6,369,2078.95,62.0,4
14697,2011-05-05,2011-05-05,218,0,0,188.60999999999996,0.0,218
14698,2011-10-19,2011-12-08,51,4,50,1250.7600000000014,12.0,1
14699,2011-05-09,2011-05-09,214,0,0,109.12999999999998,0.0,214
14700,2011-04-15,2011-11-07,238,2,206,2235.2999999999997,103.0,32
14701,2011-01-27,2011-11-29,316,6,306,2549.369999999999,51.0,10
14702,2010-12-09,2011-12-08,365,16,364,3292.139999999998,23.0,1
14703,2011-11-25,2011-11-25,14,0,0,318.16999999999996,0.0,14
14704,2011-06-12,2011-11-28,180,8,169,1546.9099999999999,21.0,11
14705,2011-05-25,2011-05-25,198,0,0,179.0,0.0,198
14708,2010-12-06,2011-12-07,368,2,366,1126.37,183.0,2
14709,2010-12-16,2011-11-24,358,11,343,4921.040000000007,31.0,15
14710,2011-10-11,2011-11-25,59,3,45,606.1300000000002,15.0,14
14711,2011-03-22,2011-11-29,262,10,252,2868.7999999999965,25.0,10
14712,2011-08-19,2011-11-10,112,2,83,917.07,42.0,29
14713,2010-12-09,2011-11-30,365,10,356,2666.36,36.0,9
14714,2011-11-15,2011-11-15,24,0,0,160.19,0.0,24
14715,2011-01-12,2011-11-15,331,3,307,867.3800000000001,102.0,24
14716,2011-07-14,2011-10-27,148,1,105,329.6799999999999,105.0,43
14719,2011-04-04,2011-12-08,249,4,248,1602.1300000000008,62.0,1
14720,2011-08-05,2011-12-04,126,2,121,663.8100000000003,60.0,5
14722,2011-07-15,2011-07-15,147,0,0,187.91999999999996,0.0,147
14723,2010-12-03,2011-11-29,371,4,361,1158.2999999999997,90.0,10
14725,2011-11-15,2011-11-15,24,0,0,718.08,0.0,24
14727,2011-03-10,2011-03-10,274,0,0,268.58000000000004,0.0,274
14729,2010-12-01,2010-12-01,373,0,0,313.49,0.0,373
14730,2011-03-08,2011-12-08,276,6,275,2005.0600000000063,46.0,1
14731,2011-05-11,2011-10-23,212,2,165,380.02,82.0,47
14732,2011-01-04,2011-12-01,339,7,331,2702.49,47.0,8
14733,2010-12-07,2011-11-23,367,11,351,9585.909999999998,32.0,16
14735,2010-12-16,2011-12-06,358,19,355,6065.69,19.0,3
14737,2010-12-21,2011-12-06,353,2,350,1164.55,175.0,3
14738,2011-01-27,2011-10-28,316,6,274,1314.4500000000003,46.0,42
14739,2010-12-07,2011-12-05,367,6,363,3902.28,60.0,4
14740,2011-03-01,2011-05-26,283,2,86,1448.2099999999994,43.0,197
14741,2010-12-02,2011-11-28,372,5,361,1400.3400000000004,72.0,11
14744,2010-12-08,2011-11-23,366,5,350,1099.98,70.0,16
14745,2011-02-27,2011-08-19,285,3,173,1220.2600000000002,58.0,112
14747,2011-04-04,2011-04-04,249,0,0,328.2,0.0,249
14748,2010-12-06,2011-11-10,368,3,339,1415.7499999999998,113.0,29
14752,2011-10-27,2011-10-27,43,0,0,389.64,0.0,43
14753,2011-09-13,2011-09-13,87,0,0,563.15,0.0,87
14754,2011-02-17,2011-10-26,295,1,251,638.0500000000001,251.0,44
14755,2011-01-09,2011-11-30,334,10,325,5010.279999999999,32.0,9
14756,2011-11-24,2011-11-24,15,0,0,738.9599999999999,0.0,15
14757,2011-09-25,2011-09-25,75,0,0,420.5,0.0,75
14758,2011-03-25,2011-07-18,259,3,115,1484.0599999999997,38.0,144
14759,2011-04-21,2011-12-05,232,2,228,1625.9699999999993,114.0,4
14760,2011-02-15,2011-02-15,297,0,0,89.2,0.0,297
14761,2011-01-09,2011-10-12,334,1,276,255.90000000000003,276.0,58
14762,2011-03-21,2011-03-21,263,0,0,300.52,0.0,263
14764,2011-10-24,2011-10-24,46,0,0,278.30000000000007,0.0,46
14765,2011-06-16,2011-11-10,176,2,147,254.10999999999996,74.0,29
14766,2010-12-08,2011-12-01,366,5,358,2473.37,72.0,8
14768,2011-08-04,2011-11-22,127,1,110,192.60000000000002,110.0,17
14769,2010-12-17,2011-12-07,357,7,355,10674.750000000007,51.0,2
14770,2011-01-20,2011-04-21,323,1,91,876.4199999999997,91.0,232
14772,2011-08-19,2011-08-19,112,0,0,139.26,0.0,112
14775,2010-12-02,2011-10-12,372,2,314,1011.9000000000002,157.0,58
14776,2011-01-31,2011-10-19,312,8,261,2538.299999999999,33.0,51
14778,2011-02-04,2011-08-04,308,1,181,730.8599999999999,181.0,127
14779,2011-01-20,2011-03-04,323,2,43,386.1499999999999,22.0,280
14780,2011-09-21,2011-10-16,79,1,25,447.67999999999995,25.0,54
14782,2011-01-24,2011-01-24,319,0,0,200.10000000000002,0.0,319
14784,2011-01-20,2011-11-13,323,1,297,289.99000000000007,297.0,26
14785,2011-11-24,2011-11-29,15,1,5,77.4,5.0,10
14788,2011-11-13,2011-12-02,26,1,19,679.4399999999998,19.0,7
14789,2011-11-11,2011-11-11,28,0,0,197.64000000000001,0.0,28
14790,2011-03-31,2011-11-23,253,3,237,745.0600000000002,79.0,16
14792,2011-10-07,2011-10-07,63,0,0,6.2,0.0,63
14793,2011-11-18,2011-11-18,21,0,0,228.99,0.0,21
14794,2011-01-09,2011-12-07,334,6,332,1319.9099999999996,55.0,2
14795,2011-06-26,2011-06-26,166,0,0,131.45,0.0,166
14796,2010-12-08,2011-12-08,366,16,365,8022.489999999978,23.0,1
14798,2011-02-02,2011-10-18,310,2,258,173.74,129.0,52
14799,2011-10-19,2011-10-19,51,0,0,157.70000000000002,0.0,51
14800,2010-12-05,2011-10-23,369,11,322,4339.739999999999,29.0,47
14801,2011-10-09,2011-10-09,61,0,0,193.1399999999999,0.0,61
14803,2011-02-20,2011-06-30,292,2,130,845.5500000000002,65.0,162
14804,2011-12-01,2011-12-01,8,0,0,353.27,0.0,8
14805,2011-01-30,2011-11-24,313,3,298,554.65,99.0,15
14806,2011-09-25,2011-09-25,75,0,0,193.39000000000004,0.0,75
14808,2011-06-20,2011-10-31,172,5,133,2741.169999999997,27.0,39
14810,2010-12-05,2011-10-30,369,10,329,2087.879999999999,33.0,40
14813,2010-12-05,2010-12-05,369,0,0,155.42999999999998,0.0,369
14815,2011-10-03,2011-11-03,67,1,31,778.5,31.0,36
14816,2011-05-26,2011-05-26,197,0,0,271.85,0.0,197
14817,2011-03-07,2011-05-23,277,1,77,1110.3399999999997,77.0,200
14818,2011-03-31,2011-09-27,253,2,180,657.8,90.0,73
14819,2011-05-31,2011-10-06,192,1,128,272.06999999999994,128.0,64
14820,2011-06-19,2011-11-18,173,3,152,507.29000000000013,51.0,21
14821,2010-12-08,2010-12-08,366,0,0,48.80000000000001,0.0,366
14823,2011-05-29,2011-06-12,194,1,14,321.4299999999999,14.0,180
14824,2011-09-09,2011-11-29,91,3,81,1127.7100000000003,27.0,10
14825,2010-12-06,2011-12-06,368,11,365,2226.9099999999985,33.0,3
14828,2011-01-07,2011-05-27,336,2,140,2139.7599999999998,70.0,196
14829,2010-12-02,2011-11-10,372,3,343,697.55,114.0,29
14830,2011-10-17,2011-10-17,53,0,0,197.13,0.0,53
14834,2011-04-13,2011-11-22,240,5,223,1720.3000000000004,45.0,17
14836,2011-11-09,2011-11-29,30,2,20,102.45000000000002,10.0,10
14837,2011-05-22,2011-09-11,201,3,112,1649.5000000000011,37.0,89
14840,2011-03-17,2011-03-17,267,0,0,62.85,0.0,267
14841,2010-12-16,2011-10-17,358,5,305,3295.7599999999998,61.0,53
14842,2011-02-04,2011-10-27,308,3,265,2824.6899999999996,88.0,43
14844,2011-04-12,2011-10-07,241,3,178,3189.8099999999995,59.0,63
14847,2011-07-14,2011-07-14,148,0,0,309.4,0.0,148
14849,2010-12-01,2011-11-18,373,12,352,7930.539999999996,29.0,21
14850,2011-02-01,2011-02-01,311,0,0,325.75,0.0,311
14851,2011-03-28,2011-11-16,256,1,233,511.34999999999997,233.0,23
14852,2011-04-01,2011-10-12,252,4,194,2836.6899999999982,48.0,58
14853,2011-05-12,2011-11-15,211,1,187,475.79999999999995,187.0,24
14854,2011-03-10,2011-09-22,274,6,196,2759.8300000000004,33.0,78
14855,2011-07-28,2011-08-12,134,1,15,645.6500000000001,15.0,119
14856,2011-10-14,2011-11-03,56,1,20,1311.3800000000006,20.0,36
14857,2011-07-14,2011-10-11,148,1,89,1173.1199999999997,89.0,59
14859,2011-05-19,2011-11-27,204,2,192,1353.739999999999,96.0,12
14860,2011-11-20,2011-11-20,19,0,0,170.32,0.0,19
14861,2011-10-18,2011-10-18,52,0,0,125.79000000000002,0.0,52
14862,2011-07-14,2011-11-14,148,1,123,841.2,123.0,25
14863,2011-11-10,2011-11-10,29,0,0,266.76,0.0,29
14865,2010-12-02,2011-12-02,372,1,365,52.199999999999996,365.0,7
14866,2010-12-08,2011-11-29,366,10,356,14389.900000000007,36.0,10
14867,2011-01-07,2011-06-07,336,2,151,710.2800000000001,76.0,185
14868,2011-04-20,2011-12-06,233,6,230,2953.590000000002,38.0,3
14869,2011-08-28,2011-12-01,103,1,95,725.7,95.0,8
14870,2011-03-23,2011-03-23,261,0,0,327.24999999999994,0.0,261
14871,2010-12-14,2011-12-06,360,3,357,522.3799999999997,119.0,3
14873,2011-05-13,2011-05-13,210,0,0,519.68,0.0,210
14875,2011-03-22,2011-08-24,262,1,155,1465.3200000000004,155.0,107
14878,2010-12-16,2011-11-27,358,8,346,1485.5400000000006,43.0,12
14880,2011-02-24,2011-09-23,288,2,211,706.1900000000002,106.0,77
14881,2011-11-20,2011-11-20,19,0,0,255.4,0.0,19
14882,2011-11-06,2011-11-13,33,1,7,589.7,7.0,26
14883,2011-05-12,2011-11-21,211,4,193,761.5900000000001,48.0,18
14885,2011-07-31,2011-07-31,131,0,0,765.3199999999999,0.0,131
14886,2011-04-01,2011-04-01,252,0,0,364.80000000000007,0.0,252
14887,2011-09-21,2011-09-21,79,0,0,1862.0,0.0,79
14888,2011-05-16,2011-05-16,207,0,0,369.20000000000005,0.0,207
14889,2011-01-07,2011-01-07,336,0,0,135.9,0.0,336
14890,2011-03-31,2011-03-31,253,0,0,125.65,0.0,253
14891,2011-06-05,2011-07-14,187,1,39,554.3800000000001,39.0,148
14893,2011-11-28,2011-11-30,11,1,2,1237.8500000000004,2.0,9
14894,2011-09-15,2011-09-15,85,0,0,655.7499999999999,0.0,85
14895,2011-02-22,2011-12-02,290,10,283,11138.710000000006,28.0,7
14896,2010-12-09,2011-05-19,365,1,161,468.77,161.0,204
14897,2011-02-16,2011-12-02,296,3,289,1366.38,96.0,7
14898,2010-12-03,2011-11-16,371,5,348,1303.5199999999995,70.0,23
14901,2010-12-02,2011-11-28,372,8,361,1421.2900000000004,45.0,11
14902,2011-11-14,2011-11-14,25,0,0,332.66,0.0,25
14903,2011-03-06,2011-11-18,278,4,257,2810.63,64.0,21
14904,2011-11-14,2011-12-07,25,1,23,1025.4399999999998,23.0,2
14905,2011-04-20,2011-07-05,233,1,76,616.1500000000002,76.0,157
14907,2010-12-07,2011-12-06,367,5,364,3501.0999999999976,73.0,3
14908,2011-09-26,2011-09-26,74,0,0,277.79999999999995,0.0,74
14910,2011-10-16,2011-12-07,54,3,52,434.35000000000014,17.0,2
14911,2010-12-01,2011-12-08,373,131,372,143825.05999999944,3.0,1
14912,2011-04-07,2011-11-23,246,1,230,867.8499999999998,230.0,16
14913,2010-12-15,2011-11-04,359,3,324,1227.4300000000005,108.0,35
14915,2011-03-07,2011-09-09,277,1,186,307.48,186.0,91
14916,2011-01-19,2011-09-30,324,3,254,1268.9799999999998,85.0,70
14918,2011-07-08,2011-08-16,154,1,39,1610.1499999999999,39.0,115
14920,2011-05-11,2011-05-11,212,0,0,977.77,0.0,212
14921,2011-05-22,2011-11-09,201,1,171,1316.0700000000004,171.0,30
14923,2011-10-20,2011-10-20,50,0,0,749.0999999999999,0.0,50
14924,2011-04-08,2011-04-08,245,0,0,310.05,0.0,245
14929,2011-11-07,2011-11-07,32,0,0,223.88,0.0,32
14930,2011-03-10,2011-08-23,274,1,166,2372.860000000001,166.0,108
14931,2011-04-13,2011-12-05,240,4,236,1257.68,59.0,4
14932,2010-12-09,2010-12-09,365,0,0,363.53,0.0,365
14934,2011-03-02,2011-09-19,282,1,201,1890.9400000000005,201.0,81
14935,2011-02-15,2011-02-15,297,0,0,1784.7099999999998,0.0,297
14936,2011-03-09,2011-11-06,275,4,242,8137.0199999999995,60.0,33
14937,2011-08-01,2011-10-14,130,1,74,1621.88,74.0,56
14944,2011-02-16,2011-11-10,296,6,267,5900.250000000002,44.0,29
14946,2011-11-25,2011-11-25,14,0,0,100.9,0.0,14
14947,2011-08-01,2011-09-28,130,1,58,290.82000000000005,58.0,72
14948,2011-05-04,2011-11-16,219,5,196,1101.9699999999996,39.0,23
14950,2011-11-20,2011-11-20,19,0,0,371.2,0.0,19
14951,2011-09-21,2011-09-21,79,0,0,311.69000000000005,0.0,79
14952,2010-12-10,2011-10-11,364,7,305,8099.489999999998,44.0,59
14953,2011-11-14,2011-11-14,25,0,0,289.82,0.0,25
14954,2011-11-27,2011-11-27,12,0,0,336.16999999999985,0.0,12
14957,2011-03-31,2011-03-31,253,0,0,58.49000000000001,0.0,253
14958,2011-04-08,2011-07-15,245,2,98,499.6799999999999,49.0,147
14959,2011-02-16,2011-10-06,296,3,232,695.42,77.0,64
14960,2011-06-21,2011-12-01,171,1,163,221.26999999999992,163.0,8
14961,2010-12-14,2011-11-29,360,7,350,7044.680000000002,50.0,10
14962,2011-03-14,2011-03-14,270,0,0,126.7,0.0,270
14963,2011-06-09,2011-11-30,183,4,174,1487.8000000000013,44.0,9
14964,2011-04-06,2011-04-06,247,0,0,206.21000000000004,0.0,247
14965,2011-09-04,2011-09-04,96,0,0,598.9999999999999,0.0,96
14966,2011-11-25,2011-11-25,14,0,0,191.3199999999999,0.0,14
14967,2011-10-21,2011-10-21,49,0,0,463.8,0.0,49
14968,2011-11-09,2011-11-09,30,0,0,147.59,0.0,30
14970,2011-01-27,2011-10-02,316,3,248,1592.06,83.0,68
14971,2011-10-27,2011-11-04,43,1,8,1116.5699999999993,8.0,35
14972,2011-08-03,2011-08-03,128,0,0,114.77000000000002,0.0,128
14973,2011-04-28,2011-08-24,225,2,118,1314.45,59.0,107
14974,2011-11-02,2011-11-02,37,0,0,114.39,0.0,37
14975,2011-10-13,2011-10-13,57,0,0,279.94,0.0,57
14976,2011-01-17,2011-10-13,326,4,269,790.8599999999997,67.0,57
14978,2011-01-13,2011-09-28,330,4,258,1931.4200000000028,64.0,72
14981,2011-04-07,2011-04-07,246,0,0,102.11999999999998,0.0,246
14984,2011-06-12,2011-11-20,180,1,161,213.26999999999998,161.0,19
14985,2010-12-16,2011-05-25,358,1,160,296.7499999999999,160.0,198
14987,2010-12-09,2011-11-24,365,1,350,326.4,350.0,15
14988,2011-05-12,2011-05-12,211,0,0,334.54,0.0,211
14995,2011-03-04,2011-11-01,280,1,242,233.23000000000002,242.0,38
14997,2011-06-14,2011-10-24,178,2,132,546.2,66.0,46
14998,2011-04-12,2011-06-22,241,1,71,429.8699999999999,71.0,170
15000,2011-10-23,2011-10-23,47,0,0,490.52,0.0,47
15002,2010-12-07,2011-08-16,367,3,252,1641.7599999999998,84.0,115
15004,2011-07-15,2011-07-15,147,0,0,1246.3199999999995,0.0,147
15005,2010-12-08,2011-11-24,366,27,351,6316.569999999991,13.0,15
15006,2011-10-19,2011-10-19,51,0,0,502.08999999999975,0.0,51
15007,2011-07-03,2011-07-03,159,0,0,156.91000000000003,0.0,159
15009,2011-11-14,2011-11-27,25,2,13,1261.78,6.0,12
15010,2011-11-04,2011-11-04,35,0,0,308.94000000000005,0.0,35
15012,2010-12-01,2011-10-17,373,1,320,423.0399999999996,320.0,53
15014,2011-06-16,2011-10-27,176,1,133,260.16999999999996,133.0,43
15016,2011-06-20,2011-06-20,172,0,0,170.04,0.0,172
15017,2011-11-06,2011-11-06,33,0,0,125.58000000000003,0.0,33
15018,2010-12-07,2011-11-01,367,2,329,496.21,164.0,38
15019,2011-03-18,2011-03-18,266,0,0,265.9999999999999,0.0,266
15021,2010-12-08,2011-12-01,366,7,358,1914.8200000000024,51.0,8
15022,2011-10-23,2011-11-28,47,2,36,905.0399999999995,18.0,11
15023,2010-12-05,2011-12-06,369,10,366,6802.759999999989,37.0,3
15024,2010-12-07,2011-11-30,367,6,358,1661.3300000000006,60.0,9
15025,2011-11-06,2011-11-06,33,0,0,377.01,0.0,33
15026,2011-03-07,2011-09-20,277,2,197,469.0,98.0,80
15027,2011-04-15,2011-11-09,238,3,208,1066.1499999999996,69.0,30
15028,2010-12-06,2011-12-01,368,2,360,627.13,180.0,8
15030,2011-03-16,2011-09-29,268,1,197,518.28,197.0,71
15031,2011-03-02,2011-12-05,282,3,278,668.14,93.0,4
15032,2010-12-08,2011-03-28,366,1,110,4959.0999999999985,110.0,256
15033,2011-01-14,2011-12-05,329,9,325,2586.6700000000014,36.0,4
15034,2010-12-21,2011-11-24,353,6,338,4308.609999999999,56.0,15
15035,2011-09-11,2011-09-11,89,0,0,252.73,0.0,89
15036,2011-06-13,2011-09-28,179,2,107,465.55,54.0,72
15038,2010-12-05,2011-10-12,369,5,311,705.4899999999997,62.0,58
15039,2010-12-06,2011-11-30,368,41,359,19914.439999999966,9.0,9
15041,2011-06-22,2011-06-22,170,0,0,180.35000000000002,0.0,170
15042,2011-05-24,2011-05-24,199,0,0,135.93,0.0,199
15043,2011-11-08,2011-11-08,31,0,0,537.0,0.0,31
15044,2010-12-12,2011-11-20,362,14,343,7700.229999999997,24.0,19
15045,2011-03-27,2011-07-11,257,1,106,735.6600000000001,106.0,151
15046,2011-01-05,2011-11-30,338,14,329,5213.770000000001,24.0,9
15047,2011-03-15,2011-03-15,269,0,0,343.61999999999995,0.0,269
15048,2010-12-06,2011-10-05,368,3,303,384.04999999999984,101.0,65
15049,2011-03-11,2011-03-11,273,0,0,121.17000000000002,0.0,273
15050,2011-09-29,2011-11-14,71,1,46,1782.0900000000004,46.0,25
15051,2011-07-12,2011-11-16,150,2,127,1391.6100000000001,64.0,23
15052,2011-01-24,2011-01-24,319,0,0,215.78,0.0,319
15053,2011-03-03,2011-12-05,281,2,277,697.79,138.0,4
15054,2011-10-30,2011-11-27,40,1,28,302.09999999999997,28.0,12
15057,2011-01-28,2011-03-09,315,1,40,1489.5,40.0,275
15058,2011-01-31,2011-11-14,312,7,287,2124.9900000000025,41.0,25
15059,2011-01-09,2011-10-30,334,6,294,1337.7200000000007,49.0,40
15060,2011-11-30,2011-12-01,9,1,1,303.0899999999999,1.0,8
15061,2010-12-02,2011-12-06,372,28,369,54534.140000000014,13.0,3
15062,2010-12-15,2011-09-29,359,3,288,987.8599999999999,96.0,71
15063,2011-05-10,2011-05-10,213,0,0,370.79999999999995,0.0,213
15065,2011-02-21,2011-11-02,291,3,254,3158.1300000000006,85.0,37
15066,2011-10-17,2011-10-17,53,0,0,893.59,0.0,53
15067,2011-03-02,2011-09-22,282,1,204,1744.7600000000004,204.0,78
15068,2011-03-28,2011-10-24,256,1,210,553.3599999999998,210.0,46
15069,2011-06-13,2011-06-13,179,0,0,1109.5300000000007,0.0,179
15070,2010-12-02,2010-12-02,372,0,0,106.2,0.0,372
15071,2011-03-09,2011-09-07,275,1,182,982.0699999999998,182.0,93
15073,2011-06-06,2011-11-30,186,2,177,1043.4099999999999,88.0,9
15074,2011-08-26,2011-08-26,105,0,0,748.8700000000002,0.0,105
15075,2011-09-23,2011-09-23,77,0,0,773.0300000000002,0.0,77
15076,2011-06-20,2011-06-20,172,0,0,880.8500000000004,0.0,172
15078,2010-12-06,2011-12-02,368,19,361,9743.110000000022,19.0,7
15079,2010-12-09,2011-05-11,365,2,153,895.61,76.0,212
15081,2010-12-07,2011-11-17,367,4,345,504.7999999999999,86.0,22
15083,2011-03-28,2011-03-28,256,0,0,88.19999999999999,0.0,256
15087,2011-03-03,2011-03-03,281,0,0,306.94000000000005,0.0,281
15088,2011-10-03,2011-11-18,67,1,46,1160.07,46.0,21
15089,2011-08-03,2011-11-29,128,5,118,2420.8400000000024,24.0,10
15090,2011-02-04,2011-02-04,308,0,0,381.32000000000005,0.0,308
15091,2011-10-03,2011-10-03,67,0,0,480.71,0.0,67
15092,2011-03-01,2011-05-08,283,1,68,457.80999999999995,68.0,215
15093,2010-12-02,2011-11-21,372,5,354,4597.019999999998,71.0,18
15095,2011-05-20,2011-08-28,203,2,100,1370.5999999999997,50.0,103
15096,2011-10-28,2011-10-28,42,0,0,219.39000000000004,0.0,42
15097,2011-12-05,2011-12-05,4,0,0,248.07999999999996,0.0,4
15098,2011-06-10,2011-06-10,182,0,0,39916.5,0.0,182
15099,2011-09-16,2011-09-16,84,0,0,410.47999999999996,0.0,84
15100,2010-12-01,2011-01-10,373,2,40,876.0,20.0,333
15101,2010-12-15,2011-12-01,359,1,351,317.53000000000003,351.0,8
15103,2011-09-14,2011-11-08,86,1,55,703.3599999999998,55.0,31
15104,2011-03-02,2011-05-27,282,1,86,1027.44,86.0,196
15105,2011-07-28,2011-11-21,134,4,116,2298.930000000001,29.0,18
15106,2011-03-15,2011-11-22,269,4,252,1422.5200000000002,63.0,17
15107,2010-12-02,2011-02-01,372,5,61,319.50000000000006,12.0,311
15108,2011-04-26,2011-07-21,227,3,86,1300.2500000000002,29.0,141
15109,2011-04-08,2011-04-08,245,0,0,484.95,0.0,245
15110,2011-01-25,2011-11-16,318,3,295,996.1,98.0,23
15111,2010-12-02,2011-11-10,372,2,343,1567.4799999999998,172.0,29
15113,2011-10-16,2011-11-30,54,2,45,3609.330000000001,22.0,9
15114,2011-02-11,2011-11-09,301,9,271,2760.5599999999977,30.0,30
15115,2011-11-21,2011-11-21,18,0,0,340.11000000000007,0.0,18
15116,2011-05-19,2011-11-22,204,3,187,1352.7500000000002,62.0,17
15117,2011-05-08,2011-11-25,215,4,201,1551.7800000000002,50.0,14
15118,2011-07-28,2011-07-28,134,0,0,244.8,0.0,134
15119,2011-04-08,2011-04-08,245,0,0,266.4,0.0,245
15120,2011-07-29,2011-07-29,133,0,0,358.8199999999999,0.0,133
15121,2011-02-24,2011-10-20,288,1,238,457.71999999999997,238.0,50
15122,2011-02-15,2011-08-17,297,2,183,1633.7799999999993,92.0,114
15123,2011-05-17,2011-12-02,206,1,199,2199.309999999999,199.0,7
15124,2011-06-01,2011-11-17,191,1,169,184.19000000000003,169.0,22
15125,2011-03-14,2011-11-14,270,9,245,11528.480000000001,27.0,25
15127,2011-10-05,2011-10-05,65,0,0,406.53000000000003,0.0,65
15128,2011-05-04,2011-10-10,219,3,159,1471.0000000000007,53.0,60
15129,2011-02-21,2011-10-20,291,9,241,3447.4,27.0,50
15130,2011-06-23,2011-06-23,169,0,0,330.11,0.0,169
15132,2011-03-22,2011-11-21,262,4,244,977.9300000000002,61.0,18
15133,2011-02-11,2011-08-04,301,2,174,982.4199999999998,87.0,127
15134,2011-04-13,2011-11-25,240,7,226,1387.9900000000002,32.0,14
15135,2011-04-14,2011-04-14,239,0,0,139.04999999999998,0.0,239
15136,2011-09-04,2011-12-07,96,2,94,1286.7000000000005,47.0,2
15139,2011-01-07,2011-04-14,336,1,97,178.96000000000006,97.0,239
15140,2011-03-20,2011-10-18,264,5,212,2354.2500000000005,42.0,52
15142,2011-10-24,2011-10-24,46,0,0,498.74,0.0,46
15143,2011-04-28,2011-04-28,225,0,0,259.45000000000005,0.0,225
15144,2011-01-31,2011-12-01,312,13,304,6580.440000000008,23.0,8
15145,2011-04-05,2011-12-05,248,3,244,1194.7300000000005,81.0,4
15146,2011-02-21,2011-06-28,291,1,127,1327.1600000000008,127.0,164
15147,2011-04-13,2011-04-13,240,0,0,623.5,0.0,240
15148,2011-11-29,2011-11-29,10,0,0,301.29,0.0,10
15149,2011-07-29,2011-07-29,133,0,0,520.8,0.0,133
15150,2011-03-15,2011-11-22,269,9,252,5314.469999999995,28.0,17
15152,2011-06-05,2011-11-30,187,12,178,4745.69,15.0,9
15153,2011-11-08,2011-11-08,31,0,0,329.25,0.0,31
15154,2011-09-25,2011-09-25,75,0,0,296.41999999999996,0.0,75
15156,2011-11-06,2011-12-08,33,2,32,961.4899999999999,16.0,1
15157,2010-12-16,2011-12-06,358,2,355,1936.0700000000006,178.0,3
15158,2011-10-25,2011-10-25,45,0,0,401.4000000000001,0.0,45
15159,2010-12-13,2011-12-08,361,18,360,18641.010000000017,20.0,1
15160,2010-12-17,2010-12-17,357,0,0,158.16000000000003,0.0,357
15163,2011-05-31,2011-11-21,192,1,174,304.4699999999999,174.0,18
15164,2011-01-04,2011-10-02,339,2,271,843.0499999999997,136.0,68
15165,2010-12-01,2010-12-01,373,0,0,487.75,0.0,373
15167,2011-01-23,2011-01-23,320,0,0,162.99999999999997,0.0,320
15168,2011-11-14,2011-11-14,25,0,0,106.56,0.0,25
15171,2011-01-12,2011-01-12,331,0,0,1289.5,0.0,331
15172,2011-04-17,2011-12-01,236,4,228,1624.0499999999997,57.0,8
15174,2011-01-21,2011-01-21,322,0,0,135.75,0.0,322
15175,2011-09-29,2011-09-29,71,0,0,224.14000000000007,0.0,71
15178,2011-03-24,2011-03-24,260,0,0,40.5,0.0,260
15179,2011-01-24,2011-11-21,319,4,301,2206.9500000000003,75.0,18
15180,2010-12-07,2010-12-07,367,0,0,87.5,0.0,367
15181,2011-03-15,2011-10-04,269,2,203,689.48,102.0,66
15182,2011-03-16,2011-07-08,268,1,114,622.8499999999999,114.0,154
15184,2011-06-02,2011-11-10,190,1,161,406.76,161.0,29
15185,2011-09-30,2011-09-30,70,0,0,310.62000000000006,0.0,70
15186,2011-06-24,2011-11-25,168,1,154,411.40999999999997,154.0,14
15187,2011-05-11,2011-12-08,212,13,211,4777.180000000001,16.0,1
15189,2011-01-11,2011-12-08,332,37,331,16225.390000000009,9.0,1
15192,2010-12-09,2011-08-12,365,2,246,1044.3200000000004,123.0,119
15193,2011-10-10,2011-10-10,60,0,0,499.32,0.0,60
15194,2010-12-06,2011-12-06,368,14,365,7616.529999999996,26.0,3
15195,2011-12-07,2011-12-07,2,0,0,3861.0,0.0,2
15197,2010-12-16,2011-11-29,358,2,348,1079.61,174.0,10
15198,2011-08-07,2011-09-08,124,1,32,193.64000000000001,32.0,92
15199,2011-02-04,2011-10-11,308,3,249,1268.7,83.0,59
15201,2011-04-06,2011-09-13,247,3,160,1236.5400000000002,53.0,87
15203,2011-02-01,2011-11-14,311,5,286,1827.7999999999984,57.0,25
15204,2010-12-17,2010-12-17,357,0,0,316.58000000000004,0.0,357
15205,2011-08-04,2011-09-15,127,1,42,653.2399999999999,42.0,85
15206,2011-03-09,2011-11-29,275,3,265,420.3,88.0,10
15208,2010-12-21,2011-12-08,353,4,352,870.12,88.0,1
15210,2011-04-28,2011-04-28,225,0,0,331.18,0.0,225
15211,2010-12-09,2011-10-10,365,1,305,894.41,305.0,60
15212,2011-04-12,2011-04-12,241,0,0,101.8,0.0,241
15213,2011-01-14,2011-01-25,329,1,11,328.35,11.0,318
15214,2011-04-11,2011-12-08,242,7,241,1661.44,34.0,1
15215,2011-09-04,2011-10-24,96,1,50,734.9400000000003,50.0,46
15216,2011-09-13,2011-09-13,87,0,0,96.6,0.0,87
15218,2011-01-25,2011-11-29,318,8,308,5756.890000000001,38.0,10
15219,2011-06-16,2011-06-16,176,0,0,305.75,0.0,176
15220,2011-03-04,2011-10-19,280,5,229,1778.9599999999994,46.0,51
15221,2010-12-08,2010-12-08,366,0,0,403.25,0.0,366
15222,2011-01-25,2011-01-25,318,0,0,585.0,0.0,318
15223,2011-04-04,2011-04-28,249,1,24,755.7500000000001,24.0,225
15224,2010-12-12,2010-12-16,362,1,4,322.0799999999999,4.0,358
15225,2011-04-19,2011-04-19,234,0,0,409.40000000000015,0.0,234
15226,2011-02-02,2011-02-02,310,0,0,154.41,0.0,310
15227,2011-01-26,2011-11-03,317,3,281,1219.4,94.0,36
15228,2011-02-18,2011-10-04,294,3,228,3386.7100000000005,76.0,66
15230,2011-04-13,2011-04-14,240,1,1,429.6000000000001,1.0,239
15232,2011-07-22,2011-08-18,140,1,27,612.0600000000001,27.0,113
15234,2011-03-08,2011-03-08,276,0,0,197.00000000000003,0.0,276
15235,2010-12-01,2011-05-06,373,9,156,2247.51,17.0,217
15236,2011-02-14,2011-02-14,298,0,0,321.05,0.0,298
15237,2011-04-26,2011-12-08,227,3,226,1412.320000000001,75.0,1
15238,2011-06-08,2011-11-10,184,2,155,1071.9899999999998,78.0,29
15239,2011-09-22,2011-11-29,78,1,68,780.59,68.0,10
15240,2011-02-01,2011-10-26,311,4,267,1706.57,67.0,44
15241,2011-03-01,2011-10-04,283,7,217,1756.4400000000007,31.0,66
15243,2011-09-26,2011-09-26,74,0,0,316.67999999999995,0.0,74
15244,2011-04-05,2011-10-05,248,1,183,631.5700000000002,183.0,65
15245,2011-03-23,2011-07-28,261,2,127,2515.8400000000006,64.0,134
15246,2010-12-16,2011-04-15,358,1,120,514.1500000000001,120.0,238
15247,2011-08-09,2011-08-09,122,0,0,356.0,0.0,122
15249,2011-03-28,2011-11-08,256,11,225,6688.460000000006,20.0,31
15251,2011-04-12,2011-11-30,241,9,232,10484.989999999996,26.0,9
15252,2011-06-09,2011-11-03,183,1,147,740.7800000000001,147.0,36
15253,2011-06-23,2011-11-23,169,2,153,918.1999999999997,76.0,16
15254,2011-08-04,2011-08-04,127,0,0,300.36000000000007,0.0,127
15255,2011-10-04,2011-10-04,66,0,0,890.8499999999999,0.0,66
15256,2011-07-14,2011-07-14,148,0,0,98.45000000000002,0.0,148
15257,2011-03-01,2011-03-01,283,0,0,317.15,0.0,283
15258,2011-05-06,2011-06-24,217,1,49,623.1600000000001,49.0,168
15260,2010-12-02,2011-08-31,372,5,272,1810.77,54.0,100
15261,2011-07-27,2011-07-27,135,0,0,254.82000000000005,0.0,135
15262,2011-01-20,2011-01-20,323,0,0,178.95000000000002,0.0,323
15263,2011-08-25,2011-08-25,106,0,0,156.50999999999996,0.0,106
15264,2011-10-06,2011-10-06,64,0,0,393.7400000000001,0.0,64
15265,2011-04-18,2011-07-11,235,1,84,1506.1200000000001,84.0,151
15266,2011-01-05,2011-01-05,338,0,0,119.30000000000001,0.0,338
15267,2011-06-10,2011-11-17,182,4,160,1717.36,40.0,22
15269,2011-11-16,2011-11-16,23,0,0,408.8,0.0,23
15270,2011-02-02,2011-11-24,310,4,295,2379.4900000000002,74.0,15
15271,2010-12-09,2011-12-02,365,14,358,2507.070000000002,26.0,7
15272,2011-09-14,2011-10-13,86,1,29,721.9399999999998,29.0,57
15274,2011-11-21,2011-12-05,18,1,14,716.5700000000003,14.0,4
15275,2011-11-02,2011-11-02,37,0,0,615.14,0.0,37
15276,2011-10-04,2011-10-04,66,0,0,135.31000000000003,0.0,66
15277,2011-10-24,2011-10-24,46,0,0,255.9,0.0,46
15279,2010-12-20,2010-12-20,354,0,0,290.51,0.0,354
15280,2011-06-20,2011-06-20,172,0,0,113.12,0.0,172
15281,2011-01-10,2011-10-12,333,8,275,2332.149999999999,34.0,58
15286,2011-10-21,2011-10-21,49,0,0,240.55,0.0,49
15287,2011-09-30,2011-11-17,70,1,48,486.69,48.0,22
15288,2010-12-09,2011-10-27,365,4,322,2306.519999999999,80.0,43
15289,2011-04-04,2011-11-10,249,2,220,939.7800000000003,110.0,29
15290,2010-12-15,2011-12-05,359,16,355,7943.22,22.0,4
15291,2010-12-01,2011-11-14,373,14,348,4668.300000000002,25.0,25
15292,2011-05-22,2011-05-22,201,0,0,180.93999999999997,0.0,201
15296,2011-01-17,2011-10-20,326,5,276,3672.86,55.0,50
15297,2011-10-07,2011-11-29,63,2,53,641.94,26.0,10
15298,2010-12-08,2011-12-07,366,10,364,4799.900000000001,36.0,2
15299,2010-12-02,2011-10-03,372,3,305,4507.01,102.0,67
15300,2011-10-06,2011-10-06,64,0,0,496.4399999999999,0.0,64
15301,2010-12-06,2011-10-20,368,9,318,5070.3499999999985,35.0,50
15303,2011-02-22,2011-02-22,290,0,0,574.02,0.0,290
15304,2010-12-06,2011-10-10,368,7,308,694.4000000000002,44.0,60
15306,2011-07-14,2011-10-06,148,2,84,1174.3499999999997,42.0,64
15307,2011-09-05,2011-09-05,95,0,0,205.3,0.0,95
15308,2011-03-10,2011-03-10,274,0,0,310.47,0.0,274
15311,2010-12-01,2011-12-09,373,89,373,60767.90000000011,4.0,0
15312,2010-12-20,2011-09-25,354,3,279,924.8500000000001,93.0,75
15313,2011-08-21,2011-08-21,110,0,0,52.0,0.0,110
15314,2011-05-24,2011-05-24,199,0,0,327.97,0.0,199
15315,2011-08-15,2011-10-06,116,1,52,570.5,52.0,64
15316,2011-01-17,2011-01-17,326,0,0,165.0,0.0,326
15318,2011-12-06,2011-12-06,3,0,0,312.62,0.0,3
15319,2011-03-01,2011-03-01,283,0,0,204.50000000000006,0.0,283
15320,2011-10-26,2011-10-26,44,0,0,267.13,0.0,44
15321,2011-02-21,2011-09-30,291,1,221,2748.3100000000004,221.0,70
15322,2011-09-15,2011-09-15,85,0,0,679.68,0.0,85
15325,2011-08-28,2011-08-28,103,0,0,162.2899999999999,0.0,103
15326,2011-01-10,2011-01-10,333,0,0,311.71,0.0,333
15327,2011-10-18,2011-10-18,52,0,0,208.75000000000003,0.0,52
15329,2011-06-21,2011-10-31,171,2,132,1049.6999999999998,66.0,39
15330,2011-10-10,2011-11-07,60,1,28,714.9599999999998,28.0,32
15332,2010-12-05,2010-12-08,369,1,3,1661.06,3.0,366
15333,2011-05-15,2011-05-15,208,0,0,1028.5600000000002,0.0,208
15334,2011-06-19,2011-07-06,173,2,17,351.6699999999999,8.0,156
15335,2011-10-17,2011-10-17,53,0,0,173.97000000000003,0.0,53
15339,2011-01-25,2011-10-04,318,1,252,574.0699999999998,252.0,66
15341,2011-09-20,2011-09-20,80,0,0,2020.52,0.0,80
15342,2011-08-02,2011-08-02,129,0,0,406.09,0.0,129
15343,2011-09-13,2011-09-13,87,0,0,364.5,0.0,87
15344,2011-09-26,2011-12-09,74,2,74,563.94,37.0,0
15345,2011-10-25,2011-10-25,45,0,0,393.54,0.0,45
15346,2011-01-11,2011-01-11,332,0,0,252.42000000000004,0.0,332
15347,2010-12-08,2010-12-08,366,0,0,201.60000000000005,0.0,366
15348,2011-09-28,2011-09-28,72,0,0,158.03999999999996,0.0,72
15349,2011-06-05,2011-07-04,187,1,29,473.80999999999983,29.0,158
15350,2010-12-01,2010-12-01,373,0,0,115.65000000000003,0.0,373
15351,2010-12-05,2011-11-27,369,6,357,1960.110000000001,60.0,12
15353,2010-12-07,2011-03-30,367,1,113,777.02,113.0,254
15355,2011-10-17,2011-11-10,53,1,24,277.05000000000007,24.0,29
15356,2010-12-06,2011-11-08,368,9,337,2766.499999999999,37.0,31
15358,2010-12-09,2011-12-05,365,14,361,8347.199999999992,26.0,4
15360,2011-10-31,2011-10-31,39,0,0,427.93,0.0,39
15361,2010-12-13,2010-12-13,361,0,0,418.9200000000001,0.0,361
15363,2010-12-02,2010-12-02,372,0,0,326.00000000000006,0.0,372
15364,2011-03-30,2011-09-05,254,1,159,913.1900000000004,159.0,95
15365,2011-01-28,2011-11-14,315,3,290,2314.32,97.0,25
15366,2010-12-16,2011-09-25,358,1,283,602.5100000000001,283.0,75
15367,2011-03-09,2011-10-13,275,2,218,1877.5899999999992,109.0,57
15368,2011-11-18,2011-11-18,21,0,0,446.94000000000005,0.0,21
15370,2011-01-11,2011-10-30,332,6,292,2386.05,49.0,40
15372,2011-07-25,2011-07-25,137,0,0,2007.4,0.0,137
15373,2010-12-03,2011-12-01,371,10,363,2415.9100000000003,36.0,8
15374,2011-08-03,2011-08-03,128,0,0,168.0,0.0,128
15376,2011-05-01,2011-10-30,222,2,182,1233.3599999999997,91.0,40
15379,2010-12-16,2011-06-23,358,6,189,3703.2899999999995,32.0,169
15380,2010-12-09,2011-12-01,365,4,357,1690.2599999999995,89.0,8
15381,2011-03-16,2011-05-10,268,1,55,596.85,55.0,213
15382,2011-02-17,2011-11-25,295,4,281,5955.709999999999,70.0,14
15384,2010-12-15,2011-06-23,359,1,190,642.41,190.0,169
15385,2011-10-30,2011-10-30,40,0,0,316.88000000000005,0.0,40
15386,2011-06-06,2011-06-06,186,0,0,394.14000000000004,0.0,186
15388,2011-03-14,2011-03-14,270,0,0,140.54,0.0,270
15389,2011-06-20,2011-06-20,172,0,0,500.0,0.0,172
15392,2010-12-14,2011-12-05,360,3,356,1535.5299999999997,119.0,4
15393,2011-03-03,2011-11-23,281,1,265,231.8600000000001,265.0,16
15394,2010-12-16,2011-11-30,358,3,349,2183.5400000000004,116.0,9
15395,2011-01-18,2011-01-18,325,0,0,107.45,0.0,325
15396,2011-08-19,2011-08-19,112,0,0,288.17999999999995,0.0,112
15397,2011-02-23,2011-02-23,289,0,0,94.0,0.0,289
15398,2011-09-22,2011-11-23,78,1,62,1345.5299999999997,62.0,16
15399,2011-09-21,2011-12-08,79,2,78,815.7699999999999,39.0,1
15400,2011-03-06,2011-09-08,278,4,186,716.2,46.0,92
15402,2011-05-27,2011-07-14,196,1,48,626.77,48.0,148
15405,2011-06-03,2011-06-03,189,0,0,349.1,0.0,189
15406,2011-02-11,2011-11-08,301,1,270,510.71,270.0,31
15407,2011-02-07,2011-11-06,305,3,272,1056.44,91.0,33
15408,2011-03-20,2011-03-20,264,0,0,267.17999999999995,0.0,264
15410,2011-03-23,2011-09-16,261,7,177,3450.8400000000015,25.0,84
15411,2011-06-10,2011-11-13,182,3,156,1358.8800000000003,52.0,26
15412,2011-06-21,2011-06-21,171,0,0,190.53000000000003,0.0,171
15414,2011-04-11,2011-11-30,242,2,233,774.9000000000001,116.0,9
15415,2011-01-30,2011-01-30,313,0,0,572.81,0.0,313
15416,2011-03-02,2011-10-06,282,3,218,3984.3199999999993,73.0,64
15417,2011-09-15,2011-09-15,85,0,0,508.8000000000001,0.0,85
15419,2011-11-15,2011-11-15,24,0,0,135.86,0.0,24
15421,2011-02-02,2011-10-12,310,2,252,950.3599999999996,126.0,58
15422,2011-01-20,2011-01-20,323,0,0,97.7,0.0,323
15423,2011-11-01,2011-11-01,38,0,0,43.5,0.0,38
15424,2011-03-30,2011-03-30,254,0,0,383.34000000000003,0.0,254
15426,2010-12-05,2011-11-20,369,3,350,1447.39,117.0,19
15427,2011-10-23,2011-11-06,47,1,14,1483.1399999999999,14.0,33
15428,2011-11-24,2011-11-24,15,0,0,93.78,0.0,15
15429,2011-09-25,2011-11-13,75,1,49,397.3499999999998,49.0,26
15432,2011-11-16,2011-11-16,23,0,0,171.19000000000005,0.0,23
15433,2011-03-17,2011-05-10,267,1,54,533.2999999999998,54.0,213
15434,2011-05-23,2011-12-01,200,3,192,1041.4800000000005,64.0,8
15435,2011-11-17,2011-11-17,22,0,0,149.29000000000005,0.0,22
15436,2011-04-19,2011-11-27,234,2,222,1122.5300000000007,111.0,12
15437,2011-03-22,2011-03-22,262,0,0,200.16000000000003,0.0,262
15438,2011-07-31,2011-07-31,131,0,0,156.57999999999998,0.0,131
15440,2011-05-15,2011-10-16,208,2,154,383.67999999999995,77.0,54
15442,2011-04-05,2011-04-05,248,0,0,594.0,0.0,248
15443,2011-01-23,2011-12-08,320,6,319,3236.909999999999,53.0,1
15444,2011-10-30,2011-11-30,40,1,31,1418.2600000000016,31.0,9
15445,2011-03-20,2011-03-20,264,0,0,113.5,0.0,264
15447,2011-01-13,2011-01-13,330,0,0,155.17000000000002,0.0,330
15448,2011-01-31,2011-01-31,312,0,0,494.64000000000004,0.0,312
15449,2011-03-23,2011-11-13,261,2,235,974.5200000000001,118.0,26
15450,2011-11-09,2011-11-09,30,0,0,429.84,0.0,30
15452,2011-03-20,2011-11-10,264,2,235,538.73,118.0,29
15453,2011-06-05,2011-12-08,187,6,186,1388.370000000001,31.0,1
15454,2010-12-12,2010-12-12,362,0,0,179.10000000000002,0.0,362
15456,2010-12-15,2011-03-01,359,1,76,447.2200000000001,76.0,283
15457,2011-03-22,2011-03-22,262,0,0,237.07000000000002,0.0,262
15458,2011-11-14,2011-11-14,25,0,0,161.64,0.0,25
15460,2010-12-20,2010-12-20,354,0,0,216.76,0.0,354
15462,2011-06-05,2011-09-06,187,2,93,234.60000000000002,46.0,94
15463,2011-11-10,2011-11-10,29,0,0,126.14,0.0,29
15464,2011-01-05,2011-01-05,338,0,0,1048.8500000000006,0.0,338
15465,2010-12-05,2011-11-20,369,17,350,7354.62,21.0,19
15466,2011-09-15,2011-09-15,85,0,0,334.53000000000014,0.0,85
15467,2011-07-10,2011-11-30,152,2,143,524.88,72.0,9
15468,2011-10-19,2011-10-19,51,0,0,467.50999999999993,0.0,51
15469,2011-08-11,2011-10-20,120,1,70,538.55,70.0,50
15471,2011-12-07,2011-12-07,2,0,0,469.47999999999985,0.0,2
15472,2011-08-18,2011-08-18,113,0,0,371.56,0.0,113
15473,2011-10-10,2011-11-25,60,3,46,1771.2,15.0,14
15475,2011-09-23,2011-09-23,77,0,0,454.10999999999984,0.0,77
15478,2011-10-14,2011-10-30,56,1,16,1441.4199999999996,16.0,40
15480,2011-08-15,2011-08-15,116,0,0,905.5,0.0,116
15482,2010-12-16,2011-11-24,358,8,343,11054.960000000003,43.0,15
15483,2011-03-18,2011-07-01,266,1,105,233.81000000000006,105.0,161
15484,2011-09-22,2011-12-08,78,3,77,3594.3099999999995,26.0,1
15485,2010-12-01,2011-11-09,373,2,343,2575.0,172.0,30
15488,2011-09-08,2011-09-08,92,0,0,91.32000000000002,0.0,92
15489,2011-05-12,2011-11-17,211,2,189,1134.28,94.0,22
15491,2011-04-18,2011-09-05,235,4,140,3100.0900000000015,35.0,95
15492,2011-09-26,2011-11-11,74,1,46,659.4599999999999,46.0,28
15493,2011-03-14,2011-11-07,270,3,238,2001.800000000005,79.0,32
15494,2011-08-10,2011-11-18,121,1,100,1299.230000000001,100.0,21
15497,2011-01-24,2011-11-22,319,1,302,1262.2,302.0,17
15498,2010-12-08,2011-12-07,366,16,364,13316.399999999992,23.0,2
15500,2011-09-19,2011-12-01,81,3,73,1131.5600000000004,24.0,8
15502,2010-12-05,2011-11-24,369,7,354,10384.93,51.0,15
15503,2010-12-12,2010-12-12,362,0,0,147.09000000000003,0.0,362
15504,2011-09-19,2011-09-19,81,0,0,52.83000000000001,0.0,81
15505,2011-07-07,2011-10-18,155,4,103,3610.9600000000005,26.0,52
15506,2011-07-24,2011-11-17,138,2,116,979.2600000000004,58.0,22
15507,2011-06-21,2011-06-21,171,0,0,492.35999999999996,0.0,171
15508,2011-04-18,2011-06-03,235,3,46,1000.2700000000003,15.0,189
15510,2011-01-13,2011-01-13,330,0,0,250.0,0.0,330
15511,2011-09-15,2011-11-28,85,4,74,909.2300000000001,18.0,11
15512,2010-12-15,2011-07-07,359,1,204,121.0,204.0,155
15513,2010-12-01,2011-11-06,373,14,340,14758.219999999996,24.0,33
15514,2010-12-10,2011-11-27,364,7,352,4139.460000000003,50.0,12
15516,2011-10-24,2011-10-26,46,1,2,62.43,2.0,44
15517,2011-04-20,2011-04-20,233,0,0,267.03000000000003,0.0,233
15518,2011-01-11,2011-10-06,332,6,268,1942.4500000000012,45.0,64
15520,2011-12-08,2011-12-08,1,0,0,343.5,0.0,1
15521,2011-03-30,2011-10-30,254,5,214,3000.2000000000007,43.0,40
15522,2011-09-13,2011-11-07,87,1,55,398.84,55.0,32
15523,2011-09-16,2011-09-16,84,0,0,412.00999999999993,0.0,84
15524,2011-11-15,2011-11-15,24,0,0,440.0,0.0,24
15525,2010-12-01,2011-12-07,373,2,371,825.9200000000003,186.0,2
15526,2011-11-06,2011-11-06,33,0,0,148.44000000000003,0.0,33
15527,2010-12-20,2011-11-21,354,7,336,2429.779999999999,48.0,18
15528,2011-03-30,2011-03-30,254,0,0,229.32999999999993,0.0,254
15529,2010-12-08,2011-11-17,366,10,344,3995.2299999999973,34.0,22
15530,2011-04-07,2011-11-18,246,3,225,1502.3500000000001,75.0,21
15531,2011-11-09,2011-12-01,30,1,22,2007.4399999999994,22.0,8
15532,2010-12-16,2011-11-14,358,3,333,1580.9300000000032,111.0,25
15533,2011-09-11,2011-11-20,89,2,70,807.5699999999997,35.0,19
15535,2011-01-16,2011-06-19,327,2,154,536.3999999999999,77.0,173
15537,2011-06-29,2011-06-29,163,0,0,110.92000000000003,0.0,163
15539,2011-12-02,2011-12-02,7,0,0,538.46,0.0,7
15540,2011-11-28,2011-11-28,11,0,0,213.3,0.0,11
15541,2011-08-17,2011-08-17,114,0,0,85.13000000000002,0.0,114
15543,2011-02-24,2011-02-24,288,0,0,127.85999999999999,0.0,288
15544,2010-12-02,2011-11-30,372,8,363,3546.709999999995,45.0,9
15545,2010-12-03,2011-10-16,371,1,317,292.7199999999999,317.0,54
15547,2010-12-12,2011-12-02,362,11,355,4954.839999999991,32.0,7
15549,2011-01-27,2011-09-23,316,2,239,1693.26,120.0,77
15550,2011-02-11,2011-12-05,301,3,297,575.63,99.0,4
15551,2011-11-03,2011-11-03,36,0,0,436.05999999999995,0.0,36
15552,2011-05-06,2011-05-06,217,0,0,90.12,0.0,217
15553,2011-10-10,2011-10-10,60,0,0,437.22999999999985,0.0,60
15554,2011-03-07,2011-03-07,277,0,0,217.2,0.0,277
15555,2010-12-05,2011-11-27,369,15,357,4805.169999999989,24.0,12
15556,2011-11-15,2011-11-15,24,0,0,279.77,0.0,24
15557,2011-11-11,2011-11-11,28,0,0,473.6500000000001,0.0,28
15561,2011-05-08,2011-11-28,215,2,204,800.59,102.0,11
15562,2010-12-23,2010-12-23,351,0,0,134.55,0.0,351
15563,2010-12-16,2011-11-17,358,2,336,1400.4399999999998,168.0,22
15565,2011-09-30,2011-10-20,70,1,20,173.16000000000005,20.0,50
15567,2011-11-21,2011-11-21,18,0,0,186.01000000000002,0.0,18
15568,2011-09-27,2011-12-07,73,2,71,758.2899999999998,36.0,2
15569,2011-01-11,2011-08-28,332,3,229,1375.7100000000003,76.0,103
15570,2010-12-05,2011-12-02,369,11,362,4165.52,33.0,7
15571,2011-09-22,2011-11-28,78,3,67,650.43,22.0,11
15572,2011-03-06,2011-12-05,278,4,274,2552.86,68.0,4
15573,2011-09-15,2011-11-08,85,1,54,607.45,54.0,31
15574,2010-12-02,2011-06-15,372,2,195,702.2500000000001,98.0,177
15576,2011-11-02,2011-11-02,37,0,0,940.6700000000001,0.0,37
15577,2011-02-07,2011-07-11,305,1,154,258.8799999999999,154.0,151
15578,2011-06-30,2011-06-30,162,0,0,127.1,0.0,162
15579,2011-01-30,2011-10-02,313,1,245,348.5999999999999,245.0,68
15581,2010-12-08,2011-08-11,366,11,246,3679.9700000000003,22.0,120
15582,2011-05-03,2011-11-15,220,2,196,682.9100000000002,98.0,24
15584,2011-06-30,2011-11-16,162,3,139,725.1099999999999,46.0,23
15585,2011-06-16,2011-06-16,176,0,0,455.30000000000007,0.0,176
15587,2010-12-23,2011-10-20,351,3,301,913.6800000000001,100.0,50
15589,2011-02-02,2011-03-29,310,1,55,478.53,55.0,255
15592,2011-10-24,2011-10-24,46,0,0,388.58,0.0,46
15593,2011-09-30,2011-09-30,70,0,0,199.8,0.0,70
15594,2011-04-19,2011-11-24,234,4,219,1771.78,55.0,15
15596,2010-12-09,2011-08-31,365,4,265,1406.5900000000004,66.0,100
15597,2011-11-04,2011-11-04,35,0,0,324.57,0.0,35
15598,2011-10-17,2011-10-17,53,0,0,240.68000000000004,0.0,53
15599,2011-05-19,2011-11-13,204,1,178,761.74,178.0,26
15601,2010-12-02,2011-11-28,372,13,361,6776.559999999998,28.0,11
15602,2010-12-06,2011-12-01,368,8,360,1297.8700000000003,45.0,8
15603,2011-09-22,2011-09-22,78,0,0,48.480000000000004,0.0,78
15604,2011-10-18,2011-10-18,52,0,0,216.39000000000004,0.0,52
15605,2010-12-01,2011-11-03,373,4,337,1198.23,84.0,36
15606,2011-01-19,2011-10-09,324,8,263,2920.1600000000003,33.0,61
15607,2011-01-07,2011-01-07,336,0,0,104.76,0.0,336
15608,2011-08-11,2011-11-11,120,2,92,1093.68,46.0,28
15609,2011-06-08,2011-06-08,184,0,0,298.48,0.0,184
15610,2011-10-19,2011-10-19,51,0,0,112.46,0.0,51
15611,2011-01-09,2011-11-30,334,11,325,1591.4500000000003,30.0,9
15612,2011-10-09,2011-11-03,61,1,25,195.15,25.0,36
15615,2010-12-15,2011-11-29,359,16,349,10399.739999999989,22.0,10
15618,2011-07-26,2011-11-07,136,2,104,776.8510000000002,52.0,32
15619,2011-11-29,2011-11-29,10,0,0,336.4,0.0,10
15620,2010-12-16,2011-10-14,358,2,302,1553.18,151.0,56
15621,2011-11-18,2011-12-05,21,2,17,1293.0300000000002,8.0,4
15622,2011-03-02,2011-10-27,282,4,239,3709.5600000000018,60.0,43
15623,2011-07-21,2011-07-21,141,0,0,301.03000000000003,0.0,141
15624,2011-03-28,2011-08-15,256,3,140,588.1300000000001,47.0,116
15625,2011-04-18,2011-08-28,235,3,132,1534.26,44.0,103
15626,2011-01-14,2011-09-26,329,1,255,675.8000000000001,255.0,74
15628,2010-12-08,2011-12-05,366,8,362,2870.2400000000002,45.0,4
15630,2011-05-19,2011-10-25,204,1,159,1186.35,159.0,45
15632,2011-03-10,2011-11-24,274,7,259,3285.310000000001,37.0,15
15634,2011-11-22,2011-11-22,17,0,0,243.55000000000004,0.0,17
15636,2011-03-02,2011-09-11,282,1,193,724.7600000000001,193.0,89
15637,2011-10-18,2011-10-18,52,0,0,223.36,0.0,52
15639,2011-07-28,2011-07-28,134,0,0,425.31999999999994,0.0,134
15640,2010-12-02,2011-12-05,372,14,368,12515.659999999982,26.0,4
15641,2010-12-15,2011-08-26,359,3,254,1887.2000000000005,85.0,105
15643,2011-03-02,2011-06-01,282,1,91,664.0000000000002,91.0,191
15644,2011-03-23,2011-06-26,261,2,95,812.9999999999998,48.0,166
15645,2011-11-21,2011-11-21,18,0,0,612.0099999999999,0.0,18
15646,2010-12-02,2011-07-05,372,2,215,447.64000000000004,108.0,157
15648,2011-03-17,2011-05-19,267,1,63,657.35,63.0,204
15649,2010-12-07,2011-01-07,367,1,31,816.0,31.0,336
15651,2011-03-24,2011-11-03,260,1,224,646.3000000000001,224.0,36
15652,2011-09-09,2011-09-09,91,0,0,337.74,0.0,91
15653,2011-08-16,2011-09-08,115,1,23,877.44,23.0,92
15654,2011-11-13,2011-11-30,26,1,17,922.5300000000003,17.0,9
15655,2011-04-10,2011-04-10,243,0,0,560.6700000000001,0.0,243
15656,2011-02-28,2011-10-25,284,3,239,748.5000000000001,80.0,45
15657,2011-11-17,2011-11-17,22,0,0,30.0,0.0,22
15658,2010-12-02,2011-06-02,372,4,182,1024.1,46.0,190
15659,2011-10-27,2011-10-27,43,0,0,306.45000000000005,0.0,43
15660,2010-12-09,2011-11-14,365,5,340,1600.86,68.0,25
15661,2011-01-05,2011-01-26,338,1,21,309.8,21.0,317
15663,2011-08-25,2011-08-25,106,0,0,138.14000000000001,0.0,106
15664,2011-10-20,2011-10-20,50,0,0,386.43,0.0,50
15665,2011-04-10,2011-06-24,243,1,75,2242.0100000000007,75.0,168
15667,2011-10-31,2011-10-31,39,0,0,301.32000000000005,0.0,39
15668,2011-05-06,2011-05-06,217,0,0,76.32000000000002,0.0,217
15669,2011-03-21,2011-10-30,263,3,223,684.34,74.0,40
15670,2011-02-16,2011-02-16,296,0,0,173.05000000000004,0.0,296
15671,2011-03-14,2011-11-21,270,6,252,2657.1300000000006,42.0,18
15673,2011-01-16,2011-09-12,327,3,239,2881.0200000000013,80.0,88
15674,2011-03-30,2011-09-27,254,4,181,2446.6,45.0,73
15675,2011-03-04,2011-09-19,280,2,199,323.69,100.0,81
15676,2011-03-01,2011-11-21,283,2,265,3435.7599999999998,132.0,18
15677,2011-10-21,2011-10-21,49,0,0,657.23,0.0,49
15678,2011-10-18,2011-10-18,52,0,0,352.7000000000001,0.0,52
15679,2011-06-10,2011-11-15,182,3,158,781.2799999999999,53.0,24
15680,2010-12-08,2011-11-30,366,2,357,1333.6800000000003,178.0,9
15681,2011-03-04,2011-11-14,280,3,255,1426.1599999999999,85.0,25
15683,2011-08-14,2011-08-14,117,0,0,193.75,0.0,117
15687,2011-01-13,2011-12-01,330,7,322,2993.099999999999,46.0,8
15689,2010-12-13,2011-08-12,361,1,242,254.1,242.0,119
15690,2011-08-31,2011-12-05,100,1,96,239.76000000000002,96.0,4
15691,2011-04-01,2011-04-01,252,0,0,136.8,0.0,252
15692,2011-11-11,2011-11-11,28,0,0,191.04000000000002,0.0,28
15694,2010-12-02,2011-12-09,372,13,372,6479.399999999998,29.0,0
15695,2011-03-18,2011-03-18,266,0,0,409.9800000000001,0.0,266
15696,2011-01-17,2011-11-06,326,7,293,2736.4600000000005,42.0,33
15699,2011-11-22,2011-11-22,17,0,0,309.6499999999999,0.0,17
15700,2011-06-19,2011-06-20,173,1,1,696.6799999999996,1.0,172
15701,2011-08-21,2011-12-07,110,3,108,1542.14,36.0,2
15703,2011-03-20,2011-03-20,264,0,0,211.5,0.0,264
15704,2011-05-08,2011-07-22,215,2,75,2293.62,38.0,140
15705,2011-05-22,2011-05-22,201,0,0,143.10000000000002,0.0,201
15706,2011-08-15,2011-10-07,116,3,53,1060.56,18.0,63
15707,2011-09-14,2011-11-04,86,3,51,945.5799999999999,17.0,35
15708,2010-12-05,2011-10-30,369,6,329,3364.2399999999984,55.0,40
15709,2011-03-01,2011-03-01,283,0,0,133.25,0.0,283
15712,2011-02-25,2011-11-30,287,4,278,1072.3600000000004,70.0,9
15713,2010-12-08,2011-07-19,366,1,223,356.7,223.0,143
15714,2011-09-23,2011-11-28,77,1,66,330.8799999999998,66.0,11
15716,2010-12-05,2011-07-17,369,3,224,1118.8100000000004,75.0,145
15717,2011-04-19,2011-04-19,234,0,0,150.30000000000004,0.0,234
15719,2011-01-06,2011-11-07,337,12,305,5045.609999999998,25.0,32
15720,2011-11-15,2011-11-15,24,0,0,598.7300000000001,0.0,24
15721,2011-11-28,2011-11-28,11,0,0,507.0799999999998,0.0,11
15722,2011-02-22,2011-11-04,290,3,255,2222.56,85.0,35
15723,2010-12-10,2010-12-10,364,0,0,203.10000000000002,0.0,364
15724,2011-02-28,2011-05-22,284,1,83,218.25000000000003,83.0,201
15725,2011-11-24,2011-11-24,15,0,0,415.2500000000001,0.0,15
15727,2010-12-15,2011-11-23,359,6,343,5178.960000000001,57.0,16
15729,2011-05-11,2011-05-11,212,0,0,85.0,0.0,212
15730,2011-05-17,2011-10-05,206,2,141,1120.8800000000003,70.0,65
15732,2010-12-02,2011-05-11,372,1,160,294.11999999999995,160.0,212
15733,2011-03-02,2011-03-02,282,0,0,162.30000000000004,0.0,282
15734,2011-05-23,2011-08-17,200,1,86,1339.45,86.0,114
15737,2011-04-11,2011-11-25,242,6,228,1205.12,38.0,14
15738,2010-12-02,2011-11-21,372,14,354,4812.419999999996,25.0,18
15739,2011-10-04,2011-10-04,66,0,0,449.12,0.0,66
15740,2011-10-21,2011-10-21,49,0,0,154.88,0.0,49
15743,2011-06-08,2011-11-23,184,3,168,784.4600000000004,56.0,16
15744,2011-09-23,2011-09-23,77,0,0,34.8,0.0,77
15745,2011-04-17,2011-11-20,236,3,217,1094.59,72.0,19
15746,2011-07-28,2011-07-28,134,0,0,196.87999999999997,0.0,134
15747,2011-06-20,2011-11-27,172,2,160,974.0399999999995,80.0,12
15748,2011-10-30,2011-10-30,40,0,0,149.30999999999997,0.0,40
15749,2011-01-11,2011-04-18,332,1,97,44534.3,97.0,235
15750,2010-12-08,2011-12-07,366,6,364,2465.479999999999,61.0,2
15752,2010-12-02,2011-10-31,372,6,333,2637.380000000003,56.0,39
15753,2011-02-08,2011-02-08,304,0,0,79.2,0.0,304
15754,2011-04-07,2011-10-19,246,2,195,458.57,98.0,51
15755,2011-02-18,2011-11-29,294,5,284,2364.2500000000023,57.0,10
15756,2011-04-04,2011-10-09,249,3,188,532.9599999999995,63.0,61
15757,2011-05-06,2011-10-05,217,1,152,714.4200000000001,152.0,65
15758,2011-11-15,2011-11-15,24,0,0,205.25000000000003,0.0,24
15759,2010-12-16,2011-05-05,358,2,140,253.04000000000002,70.0,218
15762,2011-09-23,2011-10-05,77,1,12,583.75,12.0,65
15763,2011-09-23,2011-11-08,77,1,46,1086.9200000000003,46.0,31
15764,2011-03-08,2011-09-12,276,3,188,3279.9700000000003,63.0,88
15766,2011-10-06,2011-10-06,64,0,0,315.05999999999995,0.0,64
15768,2011-04-28,2011-08-16,225,2,110,621.83,55.0,115
15769,2010-12-03,2011-12-02,371,21,364,56252.72000000001,17.0,7
15773,2011-12-04,2011-12-04,5,0,0,635.6800000000001,0.0,5
15774,2011-10-02,2011-10-02,68,0,0,270.8,0.0,68
15775,2011-04-08,2011-04-08,245,0,0,104.9,0.0,245
15776,2011-07-29,2011-07-29,133,0,0,241.62000000000003,0.0,133
15777,2010-12-13,2011-04-12,361,2,120,1047.1100000000004,60.0,241
15780,2010-12-17,2011-06-09,357,2,174,475.2800000000001,87.0,183
15781,2011-02-07,2011-11-14,305,2,280,345.4600000000001,140.0,25
15782,2011-09-11,2011-11-30,89,2,80,2614.7400000000007,40.0,9
15783,2011-11-29,2011-11-29,10,0,0,246.30000000000004,0.0,10
15785,2011-02-17,2011-11-07,295,3,263,2328.9700000000003,88.0,32
15786,2011-08-17,2011-10-24,114,1,68,4932.2000000000035,68.0,46
15787,2011-10-09,2011-11-13,61,1,35,948.0500000000001,35.0,26
15789,2010-12-16,2010-12-16,358,0,0,351.3,0.0,358
15790,2011-11-29,2011-11-29,10,0,0,220.84999999999997,0.0,10
15791,2011-05-19,2011-10-27,204,1,161,1612.6900000000003,161.0,43
15793,2011-03-16,2011-11-25,268,2,254,965.6099999999999,127.0,14
15795,2011-07-13,2011-07-13,149,0,0,610.0100000000001,0.0,149
15796,2011-02-10,2011-12-08,302,7,301,2711.5599999999995,43.0,1
15797,2011-01-24,2011-08-18,319,3,206,2207.4,69.0,113
15799,2011-01-09,2011-09-25,334,2,259,884.1400000000002,130.0,75
15800,2011-04-07,2011-08-24,246,1,139,699.0800000000002,139.0,107
15801,2011-08-22,2011-10-24,109,2,63,1063.9499999999998,32.0,46
15802,2011-07-20,2011-07-20,142,0,0,451.42,0.0,142
15803,2011-10-19,2011-10-19,51,0,0,415.82000000000005,0.0,51
15804,2011-05-25,2011-12-09,198,12,198,4206.389999999997,16.0,0
15805,2010-12-10,2011-11-16,364,12,341,5528.479999999997,28.0,23
15806,2011-03-08,2011-10-24,276,2,230,784.5799999999999,115.0,46
15807,2011-09-23,2011-10-20,77,1,27,903.9000000000002,27.0,50
15808,2010-12-05,2011-02-06,369,3,63,3734.970000000001,21.0,306
15809,2011-02-10,2011-11-03,302,4,266,515.7699999999999,66.0,36
15810,2011-02-16,2011-09-22,296,3,218,1391.9799999999998,73.0,78
15811,2010-12-09,2011-11-17,365,5,343,2218.6199999999994,69.0,22
15812,2011-01-26,2011-08-24,317,4,210,1801.14,52.0,107
15813,2011-04-14,2011-05-16,239,1,32,1303.9099999999999,32.0,207
15814,2011-10-20,2011-11-23,50,2,34,1945.3300000000004,17.0,16
15815,2011-03-25,2011-10-07,259,4,196,2100.6000000000004,49.0,63
15819,2011-03-08,2011-10-21,276,3,227,1905.45,76.0,49
15820,2011-01-24,2011-01-24,319,0,0,206.98000000000002,0.0,319
15821,2011-10-09,2011-10-26,61,1,17,570.96,17.0,44
15822,2010-12-15,2011-12-06,359,1,356,885.4699999999999,356.0,3
15823,2010-12-02,2010-12-02,372,0,0,15.0,0.0,372
15825,2011-06-20,2011-06-20,172,0,0,532.94,0.0,172
15826,2011-05-13,2011-10-14,210,1,154,1654.31,154.0,56
15827,2010-12-02,2011-09-27,372,10,299,1836.0900000000008,30.0,73
15829,2011-07-22,2011-09-01,140,1,41,636.14,41.0,99
15830,2011-11-02,2011-11-02,37,0,0,576.0,0.0,37
15831,2011-01-19,2011-10-12,324,2,266,801.7599999999999,133.0,58
15832,2011-03-30,2011-03-30,254,0,0,836.7899999999998,0.0,254
15834,2011-03-07,2011-09-30,277,2,207,2233.749999999999,104.0,70
15835,2011-01-13,2011-10-26,330,3,286,954.0899999999996,95.0,44
15836,2011-10-20,2011-10-20,50,0,0,137.37,0.0,50
15837,2011-10-06,2011-10-06,64,0,0,391.97999999999996,0.0,64
15838,2010-12-07,2011-11-28,367,14,356,33643.08,25.0,11
15839,2011-07-14,2011-11-06,148,2,115,1048.4900000000002,58.0,33
15840,2011-06-20,2011-10-12,172,1,114,355.56,114.0,58
15841,2011-01-05,2011-09-28,338,3,266,1224.0600000000004,89.0,72
15843,2011-02-09,2011-02-09,303,0,0,118.95,0.0,303
15844,2011-10-24,2011-10-24,46,0,0,130.74,0.0,46
15845,2011-01-06,2011-11-22,337,7,320,3711.7699999999995,46.0,17
15847,2011-02-24,2011-11-01,288,1,250,389.27,250.0,38
15850,2011-06-24,2011-11-20,168,1,149,238.85000000000002,149.0,19
15852,2011-05-26,2011-06-06,197,1,11,160.71,11.0,186
15853,2011-10-19,2011-10-19,51,0,0,110.80000000000001,0.0,51
15854,2010-12-13,2011-12-05,361,9,357,2974.6499999999974,40.0,4
15855,2011-03-21,2011-07-26,263,4,127,712.2399999999997,32.0,136
15856,2010-12-09,2011-12-05,365,20,361,16387.570000000003,18.0,4
15857,2011-11-21,2011-11-21,18,0,0,297.0,0.0,18
15858,2010-12-07,2011-11-24,367,4,352,1438.8500000000008,88.0,15
15860,2010-12-06,2011-10-30,368,7,328,977.2099999999992,47.0,40
15861,2011-03-17,2011-11-27,267,5,255,3165.360000000001,51.0,12
15862,2010-12-01,2011-12-01,373,3,365,832.88,122.0,8
15863,2011-05-31,2011-11-14,192,1,167,68.84,167.0,25
15864,2011-01-27,2011-11-17,316,5,294,1936.3199999999997,59.0,22
15865,2011-05-10,2011-10-30,213,2,173,895.1300000000002,86.0,40
15866,2011-08-30,2011-08-30,101,0,0,230.52999999999994,0.0,101
15867,2010-12-05,2011-12-04,369,14,364,3812.6399999999985,26.0,5
15869,2011-03-07,2011-03-07,277,0,0,149.64000000000001,0.0,277
15870,2011-11-07,2011-11-07,32,0,0,354.08999999999986,0.0,32
15872,2011-11-25,2011-11-25,14,0,0,360.9299999999999,0.0,14
15874,2011-02-28,2011-10-07,284,5,221,4405.879999999999,44.0,63
15877,2011-11-22,2011-12-08,17,1,16,493.28,16.0,1
15880,2010-12-05,2010-12-05,369,0,0,343.2799999999999,0.0,369
15881,2010-12-10,2011-01-31,364,2,52,501.39,26.0,312
15882,2010-12-06,2011-05-25,368,1,170,516.36,170.0,198
15883,2011-11-06,2011-12-07,33,1,31,396.47999999999996,31.0,2
15885,2011-02-03,2011-09-08,309,2,217,379.35,108.0,92
15886,2011-10-10,2011-10-10,60,0,0,181.09000000000003,0.0,60
15888,2011-09-20,2011-09-20,80,0,0,168.31,0.0,80
15889,2010-12-05,2011-07-06,369,1,213,446.8699999999998,213.0,156
15891,2011-04-27,2011-04-27,226,0,0,524.52,0.0,226
15894,2010-12-05,2011-03-31,369,1,116,263.54999999999995,116.0,253
15895,2011-07-13,2011-07-13,149,0,0,179.17,0.0,149
15897,2011-05-29,2011-05-29,194,0,0,222.05,0.0,194
15898,2010-12-06,2011-12-08,368,4,367,1388.8799999999999,92.0,1
15899,2010-12-06,2010-12-06,368,0,0,56.25,0.0,368
15900,2011-11-16,2011-11-16,23,0,0,351.10999999999996,0.0,23
15901,2011-07-08,2011-11-23,154,2,138,363.8799999999999,69.0,16
15903,2011-02-17,2011-11-30,295,6,286,5126.76,48.0,9
15904,2011-12-01,2011-12-01,8,0,0,164.68,0.0,8
15906,2011-03-29,2011-11-20,255,4,236,1567.6900000000014,59.0,19
15907,2011-05-13,2011-12-06,210,2,207,967.4499999999998,104.0,3
15909,2011-06-19,2011-06-19,173,0,0,191.94,0.0,173
15910,2011-01-27,2011-12-09,316,7,316,1232.1799999999996,45.0,0
15912,2011-04-20,2011-06-14,233,1,55,264.62,55.0,178
15916,2010-12-08,2011-11-23,366,6,350,1528.0900000000006,58.0,16
15917,2011-04-06,2011-04-06,247,0,0,123.10000000000002,0.0,247
15918,2011-03-13,2011-06-02,271,1,81,334.2300000000001,81.0,190
15919,2010-12-06,2011-11-20,368,1,349,639.89,349.0,19
15920,2011-07-08,2011-07-08,154,0,0,167.49999999999997,0.0,154
15921,2011-06-20,2011-06-20,172,0,0,336.03000000000003,0.0,172
15922,2010-12-01,2010-12-01,373,0,0,369.50000000000006,0.0,373
15923,2010-12-02,2010-12-02,372,0,0,127.08000000000003,0.0,372
15925,2011-05-29,2011-05-29,194,0,0,207.15000000000003,0.0,194
15930,2011-10-03,2011-10-03,67,0,0,426.63000000000017,0.0,67
15932,2011-02-23,2011-12-05,289,7,285,2495.870000000001,41.0,4
15933,2011-09-14,2011-11-18,86,2,65,1107.4600000000003,32.0,21
15935,2011-04-12,2011-04-14,241,1,2,416.8600000000001,2.0,239
15937,2011-10-06,2011-10-06,64,0,0,145.35000000000002,0.0,64
15938,2011-01-20,2011-08-19,323,4,211,404.58,53.0,112
15939,2011-01-12,2011-09-11,331,13,242,6115.009999999999,19.0,89
15940,2011-02-01,2011-02-01,311,0,0,35.8,0.0,311
15942,2011-07-29,2011-07-29,133,0,0,337.44,0.0,133
15944,2011-03-08,2011-03-08,276,0,0,325.1,0.0,276
15945,2010-12-09,2010-12-09,365,0,0,181.0,0.0,365
15947,2011-09-18,2011-09-18,82,0,0,1708.2400000000002,0.0,82
15948,2011-10-27,2011-12-01,43,1,35,955.2400000000001,35.0,8
15949,2011-09-29,2011-11-23,71,1,55,364.7199999999999,55.0,16
15950,2010-12-15,2011-11-08,359,3,328,1765.509999999999,109.0,31
15951,2011-02-27,2011-12-01,285,1,277,708.2200000000003,277.0,8
15952,2011-04-28,2011-11-06,225,3,192,806.5699999999998,64.0,33
15953,2010-12-05,2011-11-24,369,7,354,1659.3799999999999,51.0,15
15955,2010-12-02,2011-11-15,372,9,348,4416.260000000002,39.0,24
15957,2011-11-08,2011-11-08,31,0,0,428.88999999999993,0.0,31
15958,2011-09-26,2011-09-26,74,0,0,104.35,0.0,74
15963,2011-10-25,2011-11-20,45,1,26,470.7600000000001,26.0,19
15965,2010-12-07,2011-11-22,367,2,350,845.6399999999999,175.0,17
15967,2011-01-25,2011-11-16,318,1,295,418.8299999999999,295.0,23
15969,2011-06-07,2011-12-07,185,2,183,666.0999999999999,92.0,2
15970,2011-02-09,2011-02-09,303,0,0,314.1,0.0,303
15971,2011-02-01,2011-11-22,311,10,294,4199.85,29.0,17
15973,2010-12-08,2010-12-08,366,0,0,307.82000000000005,0.0,366
15974,2011-02-24,2011-10-31,288,6,249,3442.15,42.0,39
15975,2011-09-16,2011-09-16,84,0,0,371.01000000000005,0.0,84
15976,2011-05-03,2011-06-27,220,1,55,430.93999999999977,55.0,165
15977,2011-10-31,2011-11-22,39,1,22,1054.7299999999996,22.0,17
15978,2011-09-23,2011-09-23,77,0,0,1098.7800000000002,0.0,77
15980,2011-03-30,2011-09-12,254,1,166,2398.8599999999997,166.0,88
15981,2011-02-01,2011-11-15,311,7,287,3408.4799999999987,41.0,24
15983,2010-12-01,2011-11-17,373,3,351,1475.02,117.0,22
15984,2010-12-06,2011-12-07,368,9,366,2837.670000000001,41.0,2
15985,2011-04-17,2011-08-08,236,1,113,1142.42,113.0,123
15986,2011-11-09,2011-11-09,30,0,0,168.12,0.0,30
15987,2010-12-06,2011-11-27,368,5,356,1451.2800000000004,71.0,12
15988,2011-11-20,2011-11-20,19,0,0,158.03000000000003,0.0,19
15990,2011-02-25,2011-10-26,287,1,243,792.11,243.0,44
15992,2011-12-06,2011-12-06,3,0,0,41.989999999999995,0.0,3
15993,2011-10-26,2011-12-01,44,4,36,2797.5699999999983,9.0,8
15994,2011-10-16,2011-10-16,54,0,0,427.07000000000005,0.0,54
15996,2010-12-08,2011-09-12,366,5,278,1060.6799999999994,56.0,88
15998,2010-12-12,2011-11-03,362,4,326,3089.969999999999,82.0,36
16000,2011-12-07,2011-12-07,2,0,0,12393.699999999999,0.0,2
16003,2010-12-15,2011-11-10,359,3,330,2735.3700000000003,110.0,29
16005,2011-03-14,2011-11-27,270,2,258,615.389999999999,129.0,12
16006,2011-05-12,2011-05-12,211,0,0,101.4,0.0,211
16007,2011-05-08,2011-10-23,215,3,168,1701.939999999998,56.0,47
16008,2011-05-19,2011-11-16,204,2,181,478.7800000000001,90.0,23
16009,2011-07-03,2011-11-17,159,3,137,992.7099999999999,46.0,22
16010,2010-12-12,2011-04-08,362,2,117,407.49999999999994,58.0,245
16011,2010-12-08,2011-12-01,366,15,358,3362.7100000000028,24.0,8
16012,2011-07-07,2011-11-04,155,2,120,1415.2899999999997,60.0,35
16013,2010-12-03,2011-12-06,371,27,368,37130.6,14.0,3
16014,2011-02-21,2011-11-02,291,2,254,662.3799999999999,127.0,37
16015,2011-10-21,2011-12-06,49,2,46,705.3899999999996,23.0,3
16016,2010-12-08,2011-12-06,366,6,363,1508.7600000000014,60.0,3
16017,2011-10-23,2011-10-23,47,0,0,211.87999999999994,0.0,47
16018,2011-06-12,2011-10-31,180,1,141,408.90000000000003,141.0,39
16019,2010-12-10,2011-10-24,364,8,318,3786.239999999999,40.0,46
16020,2011-10-05,2011-11-23,65,1,49,851.0100000000001,49.0,16
16022,2011-03-24,2011-03-24,260,0,0,628.2800000000001,0.0,260
16023,2011-03-18,2011-10-24,266,2,220,719.81,110.0,46
16024,2011-11-27,2011-11-27,12,0,0,251.23999999999992,0.0,12
16025,2011-11-10,2011-11-10,29,0,0,439.66,0.0,29
16026,2011-10-27,2011-10-27,43,0,0,236.09000000000006,0.0,43
16027,2011-02-10,2011-09-09,302,5,211,934.62,42.0,91
16029,2010-12-01,2011-11-01,373,38,335,81024.84000000001,9.0,38
16030,2011-02-03,2011-02-03,309,0,0,331.24000000000007,0.0,309
16031,2011-04-06,2011-09-08,247,1,155,548.9399999999999,155.0,92
16033,2010-12-05,2011-12-04,369,17,364,8816.399999999987,21.0,5
16034,2011-01-11,2011-05-27,332,2,136,437.7,68.0,196
16036,2011-03-21,2011-09-13,263,1,176,758.9199999999994,176.0,87
16037,2010-12-16,2011-03-15,358,2,89,855.0200000000001,44.0,269
16038,2011-05-22,2011-12-02,201,2,194,471.7799999999999,97.0,7
16040,2011-03-16,2011-10-05,268,2,203,1313.5500000000006,102.0,65
16041,2011-07-21,2011-11-09,141,1,111,3166.4,111.0,30
16042,2011-01-11,2011-11-17,332,3,310,1197.2700000000002,103.0,22
16043,2011-01-26,2011-11-02,317,3,280,773.9900000000004,93.0,37
16045,2011-02-22,2011-08-12,290,3,171,1340.7000000000003,57.0,119
16048,2010-12-01,2010-12-01,373,0,0,256.44000000000005,0.0,373
16049,2011-09-25,2011-10-30,75,2,35,1111.7899999999993,18.0,40
16050,2011-06-19,2011-06-19,173,0,0,137.89999999999998,0.0,173
16052,2011-10-16,2011-10-16,54,0,0,362.06000000000006,0.0,54
16053,2011-08-09,2011-11-07,122,1,90,1511.9499999999996,90.0,32
16054,2011-07-17,2011-07-17,145,0,0,783.8999999999999,0.0,145
16055,2011-05-03,2011-05-03,220,0,0,134.8,0.0,220
16056,2011-10-25,2011-10-25,45,0,0,664.85,0.0,45
16057,2011-02-28,2011-11-23,284,3,268,2263.12,89.0,16
16059,2010-12-07,2011-10-05,367,5,302,1459.8600000000008,60.0,65
16062,2010-12-10,2011-11-30,364,3,355,1153.619999999999,118.0,9
16063,2011-03-24,2011-03-24,260,0,0,335.32000000000005,0.0,260
16065,2010-12-09,2010-12-09,365,0,0,372.0900000000001,0.0,365
16066,2011-08-07,2011-11-23,124,4,108,1521.8700000000001,27.0,16
16070,2011-11-07,2011-11-17,32,1,10,852.15,10.0,22
16071,2011-10-26,2011-10-26,44,0,0,326.24000000000007,0.0,44
16072,2011-02-24,2011-02-24,288,0,0,584.3199999999999,0.0,288
16073,2011-02-15,2011-02-15,297,0,0,122.4,0.0,297
16076,2011-05-15,2011-12-06,208,8,205,2234.729999999999,26.0,3
16078,2011-03-01,2011-03-01,283,0,0,79.2,0.0,283
16079,2011-10-30,2011-11-23,40,2,24,1352.0000000000002,12.0,16
16080,2011-03-10,2011-09-19,274,1,193,217.16000000000003,193.0,81
16081,2010-12-08,2011-10-14,366,4,310,2806.9000000000005,78.0,56
16083,2010-12-14,2011-08-31,360,1,260,1317.6200000000001,260.0,100
16084,2011-02-13,2011-02-13,299,0,0,436.17999999999995,0.0,299
16085,2011-01-23,2011-11-16,320,4,297,981.5099999999999,74.0,23
16086,2010-12-07,2011-10-11,367,4,308,1121.39,77.0,59
16091,2011-05-25,2011-07-08,198,1,44,315.06000000000006,44.0,154
16092,2011-03-30,2011-08-17,254,2,140,817.86,70.0,114
16093,2011-08-25,2011-08-25,106,0,0,17.0,0.0,106
16094,2011-05-04,2011-11-28,219,2,208,1078.2299999999998,104.0,11
16096,2011-03-20,2011-03-20,264,0,0,320.62,0.0,264
16097,2011-04-13,2011-04-13,240,0,0,185.05,0.0,240
16098,2010-12-01,2011-09-13,373,6,286,2005.6300000000003,48.0,87
16099,2011-04-28,2011-10-20,225,2,175,731.8999999999999,88.0,50
16101,2011-09-30,2011-09-30,70,0,0,1290.7,0.0,70
16102,2011-08-03,2011-10-28,128,2,86,1842.1400000000003,43.0,42
16103,2011-04-20,2011-12-02,233,5,226,1429.6399999999999,45.0,7
16104,2011-10-09,2011-10-09,61,0,0,302.36,0.0,61
16105,2011-04-05,2011-04-05,248,0,0,336.96,0.0,248
16106,2011-10-05,2011-10-05,65,0,0,108.38,0.0,65
16107,2011-06-09,2011-11-22,183,6,166,3204.1600000000003,28.0,17
16108,2011-09-16,2011-09-16,84,0,0,842.5,0.0,84
16109,2011-02-04,2011-05-05,308,1,90,611.8800000000001,90.0,218
16110,2011-02-01,2011-10-25,311,2,266,1337.4800000000016,133.0,45
16112,2011-01-05,2011-07-19,338,3,195,195.74,65.0,143
16113,2011-06-09,2011-06-09,183,0,0,161.38000000000002,0.0,183
16114,2011-06-22,2011-06-22,170,0,0,135.75000000000003,0.0,170
16115,2011-02-20,2011-11-30,292,7,283,1667.9700000000018,40.0,9
16116,2011-05-12,2011-05-12,211,0,0,612.7800000000001,0.0,211
16117,2011-06-03,2011-06-03,189,0,0,232.21,0.0,189
16119,2011-09-28,2011-12-01,72,1,64,423.36000000000007,64.0,8
16120,2011-10-11,2011-10-11,59,0,0,1309.14,0.0,59
16121,2011-05-08,2011-10-13,215,1,158,867.1099999999998,158.0,57
16122,2010-12-08,2011-09-27,366,3,293,684.42,98.0,73
16123,2011-10-19,2011-10-19,51,0,0,307.78000000000003,0.0,51
16124,2011-01-26,2011-01-26,317,0,0,249.00000000000003,0.0,317
16125,2010-12-07,2010-12-07,367,0,0,289.35,0.0,367
16126,2011-02-16,2011-11-10,296,3,267,6287.770000000002,89.0,29
16127,2011-10-31,2011-10-31,39,0,0,656.2500000000002,0.0,39
16128,2011-03-02,2011-11-22,282,4,265,1880.22,66.0,17
16131,2011-04-14,2011-10-19,239,3,188,3506.5400000000013,63.0,51
16133,2011-01-25,2011-12-06,318,28,315,14589.039999999997,11.0,3
16134,2010-12-15,2011-11-18,359,1,338,618.0900000000001,338.0,21
16135,2011-03-22,2011-03-22,262,0,0,517.55,0.0,262
16136,2011-03-07,2011-10-11,277,2,218,709.3800000000002,109.0,59
16139,2011-05-17,2011-11-21,206,2,188,635.41,94.0,18
16140,2010-12-03,2011-10-05,371,1,306,725.1800000000001,306.0,65
16141,2011-09-12,2011-09-12,88,0,0,620.4,0.0,88
16142,2011-04-04,2011-04-04,249,0,0,535.3400000000001,0.0,249
16143,2010-12-05,2011-12-06,369,5,366,2424.939999999999,73.0,3
16144,2011-04-07,2011-04-07,246,0,0,175.2,0.0,246
16145,2010-12-15,2011-12-01,359,10,351,3799.4899999999957,35.0,8
16146,2011-04-21,2011-07-05,232,2,75,734.1299999999999,38.0,157
16147,2011-07-29,2011-07-29,133,0,0,375.0,0.0,133
16148,2011-02-16,2011-02-16,296,0,0,76.32000000000002,0.0,296
16149,2011-07-20,2011-12-05,142,1,138,280.52000000000004,138.0,4
16150,2010-12-02,2011-10-28,372,4,330,2053.019999999999,82.0,42
16152,2011-03-16,2011-03-16,268,0,0,1829.0399999999995,0.0,268
16153,2010-12-20,2011-10-21,354,4,305,1824.2300000000002,76.0,49
16156,2011-02-02,2011-12-01,310,8,302,3122.0400000000013,38.0,8
16157,2011-09-28,2011-11-24,72,2,57,656.6899999999999,28.0,15
16159,2011-03-03,2011-03-03,281,0,0,348.2000000000001,0.0,281
16160,2011-09-15,2011-10-05,85,1,20,1025.4400000000005,20.0,65
16161,2010-12-06,2011-12-08,368,18,367,5575.559999999998,20.0,1
16162,2011-04-01,2011-04-01,252,0,0,37.4,0.0,252
16163,2010-12-09,2011-04-21,365,1,133,856.6000000000001,133.0,232
16164,2011-10-28,2011-11-22,42,2,25,822.4800000000001,12.0,17
16168,2010-12-05,2011-11-29,369,24,359,3787.600000000001,15.0,10
16169,2011-09-25,2011-12-01,75,3,67,1822.9700000000003,22.0,8
16170,2011-04-05,2011-10-20,248,5,198,1885.0499999999995,40.0,50
16171,2011-10-11,2011-10-11,59,0,0,73.19999999999999,0.0,59
16172,2011-04-12,2011-09-05,241,3,146,1140.21,49.0,95
16173,2011-09-02,2011-11-24,98,5,83,1418.3199999999993,17.0,15
16174,2011-07-11,2011-08-05,151,2,25,1009.5500000000001,12.0,126
16175,2011-04-13,2011-09-06,240,3,146,1037.5899999999997,49.0,94
16177,2011-10-20,2011-10-20,50,0,0,331.95,0.0,50
16178,2011-07-24,2011-07-24,138,0,0,197.90000000000003,0.0,138
16179,2011-10-10,2011-10-10,60,0,0,215.83,0.0,60
16180,2011-04-01,2011-08-31,252,6,152,10254.180000000002,25.0,100
16181,2011-09-27,2011-09-27,73,0,0,305.5400000000001,0.0,73
16182,2011-02-18,2011-09-28,294,3,222,6617.650000000001,74.0,72
16183,2011-10-03,2011-10-03,67,0,0,338.7100000000001,0.0,67
16184,2011-05-12,2011-10-06,211,5,147,1158.7900000000002,29.0,64
16185,2011-04-21,2011-11-23,232,1,216,529.41,216.0,16
16186,2010-12-02,2011-11-17,372,9,350,4006.9400000000032,39.0,22
16187,2011-02-28,2011-11-08,284,10,253,6911.439999999999,25.0,31
16188,2011-04-11,2011-10-26,242,3,198,981.8600000000001,66.0,44
16189,2011-09-15,2011-11-24,85,1,70,215.47999999999996,70.0,15
16190,2011-10-30,2011-10-30,40,0,0,215.08,0.0,40
16191,2010-12-14,2011-12-07,360,9,358,5180.52,40.0,2
16193,2011-04-17,2011-04-17,236,0,0,314.45000000000005,0.0,236
16198,2011-09-25,2011-09-25,75,0,0,400.6810000000001,0.0,75
16200,2011-06-28,2011-12-05,164,1,160,1080.6199999999992,160.0,4
16201,2011-08-22,2011-12-06,109,3,106,1863.4699999999993,35.0,3
16202,2010-12-14,2010-12-14,360,0,0,365.27,0.0,360
16203,2010-12-02,2011-10-12,372,3,314,592.9,105.0,58
16204,2011-11-16,2011-11-16,23,0,0,405.71000000000004,0.0,23
16205,2011-06-13,2011-11-09,179,3,149,761.38,50.0,30
16206,2011-01-16,2011-10-16,327,3,273,537.06,91.0,54
16207,2011-11-14,2011-11-14,25,0,0,394.38,0.0,25
16208,2011-02-23,2011-10-26,289,1,245,664.2600000000001,245.0,44
16209,2011-04-07,2011-09-12,246,4,158,2262.62,40.0,88
16210,2010-12-01,2011-12-08,373,16,372,21086.299999999996,23.0,1
16211,2011-09-12,2011-09-12,88,0,0,547.0200000000001,0.0,88
16212,2011-03-01,2011-11-20,283,1,264,690.3400000000001,264.0,19
16213,2011-09-22,2011-09-22,78,0,0,159.00000000000003,0.0,78
16214,2011-03-15,2011-06-22,269,2,99,1062.7499999999998,50.0,170
16215,2011-09-20,2011-09-20,80,0,0,242.35000000000005,0.0,80
16216,2011-03-17,2011-03-17,267,0,0,914.9300000000002,0.0,267
16217,2011-03-02,2011-04-18,282,1,47,304.25000000000006,47.0,235
16218,2010-12-01,2011-11-10,373,5,344,3084.6800000000017,69.0,29
16221,2010-12-07,2011-11-03,367,2,331,864.86,166.0,36
16222,2011-01-25,2011-01-25,318,0,0,846.7200000000007,0.0,318
16224,2011-04-04,2011-10-13,249,3,192,1295.3000000000004,64.0,57
16225,2011-03-07,2011-10-26,277,3,233,1096.3200000000002,78.0,44
16226,2011-04-18,2011-05-20,235,2,32,255.12000000000003,16.0,203
16227,2011-04-28,2011-04-28,225,0,0,314.22,0.0,225
16229,2011-05-11,2011-09-13,212,1,125,1010.5999999999999,125.0,87
16230,2011-05-03,2011-06-03,220,1,31,542.03,31.0,189
16232,2011-05-08,2011-10-27,215,2,172,990.8799999999998,86.0,43
16233,2010-12-08,2011-09-29,366,2,295,536.68,148.0,71
16235,2011-01-11,2011-10-30,332,4,292,867.3099999999996,73.0,40
16236,2011-09-22,2011-09-22,78,0,0,432.1999999999999,0.0,78
16239,2011-06-03,2011-10-14,189,1,133,414.2,133.0,56
16240,2011-09-23,2011-11-15,77,1,53,3718.800000000001,53.0,24
16241,2010-12-05,2011-11-30,369,11,360,2607.870000000007,33.0,9
16242,2011-03-07,2011-12-01,277,6,269,3603.210000000001,45.0,8
16243,2011-10-16,2011-11-06,54,1,21,409.09999999999974,21.0,33
16244,2010-12-02,2011-05-12,372,1,161,1522.75,161.0,211
16245,2011-03-28,2011-11-16,256,2,233,1413.660000000001,116.0,23
16247,2011-06-22,2011-06-22,170,0,0,114.56,0.0,170
16248,2011-10-09,2011-10-09,61,0,0,152.94000000000005,0.0,61
16249,2011-04-14,2011-10-18,239,4,187,1800.0700000000006,47.0,52
16250,2010-12-01,2011-03-23,373,1,112,389.4400000000001,112.0,261
16253,2011-03-29,2011-10-04,255,1,189,3683.8599999999988,189.0,66
16255,2010-12-09,2011-11-23,365,7,349,2619.91,50.0,16
16256,2011-03-18,2011-03-18,266,0,0,752.4300000000002,0.0,266
16257,2011-06-16,2011-06-16,176,0,0,46.95,0.0,176
16258,2011-05-04,2011-10-25,219,4,174,5203.51,44.0,45
16260,2011-10-20,2011-10-20,50,0,0,1035.45,0.0,50
16261,2011-04-07,2011-11-22,246,3,229,746.8299999999999,76.0,17
16265,2010-12-10,2011-11-30,364,7,355,5447.000000000003,51.0,9
16266,2011-05-17,2011-09-27,206,5,133,861.8899999999998,27.0,73
16268,2011-09-29,2011-09-29,71,0,0,667.6499999999999,0.0,71
16270,2010-12-21,2010-12-21,353,0,0,1141.2399999999996,0.0,353
16271,2010-12-16,2011-12-07,358,4,356,1429.2399999999998,89.0,2
16272,2011-08-15,2011-08-15,116,0,0,411.7000000000001,0.0,116
16274,2010-12-01,2010-12-01,373,0,0,357.94999999999993,0.0,373
16275,2011-05-27,2011-05-27,196,0,0,559.8699999999999,0.0,196
16276,2011-06-16,2011-06-16,176,0,0,810.6000000000001,0.0,176
16278,2011-08-31,2011-08-31,100,0,0,566.3799999999999,0.0,100
16279,2011-06-16,2011-11-18,176,2,155,1509.5800000000004,78.0,21
16281,2011-09-28,2011-09-28,72,0,0,2062.06,0.0,72
16282,2011-01-04,2011-01-04,339,0,0,168.3,0.0,339
16283,2011-05-15,2011-12-04,208,4,203,1570.8099999999993,51.0,5
16284,2011-10-20,2011-11-08,50,1,19,823.9699999999996,19.0,31
16287,2011-06-23,2011-06-23,169,0,0,142.50000000000003,0.0,169
16292,2011-08-10,2011-08-10,121,0,0,302.25,0.0,121
16293,2010-12-07,2011-11-18,367,5,346,2248.9900000000002,69.0,21
16295,2011-10-06,2011-11-30,64,3,55,1328.5500000000004,18.0,9
16297,2011-03-16,2011-03-16,268,0,0,301.90000000000003,0.0,268
16298,2011-06-06,2011-11-17,186,2,164,598.1999999999998,82.0,22
16302,2011-08-05,2011-08-05,126,0,0,233.22000000000003,0.0,126
16303,2011-01-10,2011-11-14,333,2,308,5360.63,154.0,25
16305,2011-07-24,2011-07-24,138,0,0,361.2199999999999,0.0,138
16306,2010-12-07,2011-05-10,367,5,154,632.2700000000001,31.0,213
16308,2011-03-23,2011-11-02,261,3,224,2560.0,75.0,37
16309,2011-04-13,2011-08-25,240,1,134,706.5700000000002,134.0,106
16311,2011-10-21,2011-11-22,49,1,32,616.26,32.0,17
16313,2011-10-21,2011-12-06,49,1,46,274.15000000000003,46.0,3
16315,2011-01-13,2011-01-13,330,0,0,226.37,0.0,330
16316,2010-12-16,2011-10-06,358,6,294,2938.9100000000008,49.0,64
16317,2011-02-15,2011-08-12,297,2,178,1341.6499999999999,89.0,119
16318,2011-11-04,2011-11-04,35,0,0,328.15,0.0,35
16319,2011-05-06,2011-05-06,217,0,0,404.40000000000003,0.0,217
16320,2011-05-10,2011-06-20,213,1,41,1038.46,41.0,172
16321,2011-01-20,2011-09-28,323,2,251,373.6500000000001,126.0,72
16322,2011-11-03,2011-12-08,36,1,35,326.75,35.0,1
16323,2011-05-27,2011-05-27,196,0,0,207.50000000000003,0.0,196
16324,2011-06-15,2011-08-03,177,1,49,428.6799999999998,49.0,128
16325,2011-04-08,2011-10-24,245,2,199,594.24,100.0,46
16326,2011-01-09,2011-12-04,334,12,329,3110.9600000000046,27.0,5
16327,2010-12-05,2011-11-25,369,5,355,3844.22,71.0,14
16330,2011-08-19,2011-11-22,112,1,95,251.91,95.0,17
16332,2011-02-07,2011-11-11,305,6,277,1593.2000000000003,46.0,28
16333,2011-02-03,2011-12-02,309,12,302,26626.8,25.0,7
16337,2011-11-03,2011-11-03,36,0,0,151.05,0.0,36
16338,2011-07-05,2011-07-05,157,0,0,214.80000000000004,0.0,157
16339,2011-02-28,2011-02-28,284,0,0,109.95000000000002,0.0,284
16340,2011-08-24,2011-08-24,107,0,0,549.0699999999998,0.0,107
16341,2011-05-22,2011-11-15,201,2,177,1971.8700000000003,88.0,24
16342,2011-06-13,2011-09-25,179,3,104,322.41,35.0,75
16343,2011-11-23,2011-11-23,16,0,0,370.47999999999996,0.0,16
16344,2011-07-04,2011-07-04,158,0,0,101.10000000000001,0.0,158
16345,2011-10-26,2011-10-26,44,0,0,575.4100000000001,0.0,44
16347,2011-11-03,2011-11-28,36,1,25,887.6500000000001,25.0,11
16348,2011-04-13,2011-11-07,240,5,208,1469.4500000000005,42.0,32
16349,2011-02-22,2011-02-22,290,0,0,53.5,0.0,290
16350,2011-01-10,2011-11-18,333,3,312,1116.4699999999996,104.0,21
16351,2011-01-11,2011-01-11,332,0,0,153.9,0.0,332
16352,2011-11-02,2011-11-22,37,1,20,494.4400000000001,20.0,17
16353,2010-12-05,2011-12-06,369,19,366,6675.709999999998,19.0,3
16354,2011-09-27,2011-10-07,73,1,10,395.79999999999995,10.0,63
16356,2011-03-07,2011-05-26,277,2,80,211.76999999999998,40.0,197
16357,2011-05-10,2011-11-06,213,2,180,658.88,90.0,33
16358,2011-06-08,2011-12-08,184,3,183,2027.499999999999,61.0,1
16359,2011-01-12,2011-12-02,331,8,324,1750.9199999999994,40.0,7
16360,2011-09-12,2011-12-05,88,5,84,3512.5299999999997,17.0,4
16361,2011-09-29,2011-11-30,71,3,62,896.6600000000001,21.0,9
16362,2011-09-09,2011-11-07,91,2,59,734.7699999999996,30.0,32
16363,2011-10-17,2011-10-17,53,0,0,109.36000000000001,0.0,53
16364,2011-07-25,2011-11-28,137,1,126,707.0399999999997,126.0,11
16365,2010-12-07,2011-11-22,367,7,350,1540.4200000000005,50.0,17
16366,2011-11-21,2011-11-21,18,0,0,327.3000000000001,0.0,18
16367,2010-12-12,2011-11-02,362,1,325,804.4899999999994,325.0,37
16368,2011-11-11,2011-12-07,28,1,26,497.42999999999984,26.0,2
16369,2011-05-27,2011-11-21,196,2,178,1553.66,89.0,18
16370,2011-04-28,2011-09-18,225,3,143,1320.5600000000004,48.0,82
16372,2011-11-06,2011-11-06,33,0,0,367.92999999999984,0.0,33
16374,2011-03-22,2011-10-04,262,1,196,473.0299999999997,196.0,66
16376,2011-11-22,2011-12-01,17,1,9,987.0100000000007,9.0,8
16377,2011-03-17,2011-03-17,267,0,0,676.2,0.0,267
16378,2011-02-02,2011-04-06,310,2,63,362.95000000000005,32.0,247
16379,2011-09-22,2011-12-05,78,3,74,2157.400000000001,25.0,4
16380,2011-10-09,2011-10-09,61,0,0,1780.5900000000004,0.0,61
16383,2011-03-16,2011-09-26,268,1,194,668.3599999999996,194.0,74
16384,2011-03-21,2011-09-11,263,1,174,584.4999999999999,174.0,89
16385,2010-12-08,2011-10-10,366,2,306,555.8900000000001,153.0,60
16386,2011-03-31,2011-11-11,253,1,225,317.20000000000016,225.0,28
16387,2011-01-21,2011-01-21,322,0,0,94.36,0.0,322
16389,2011-03-01,2011-10-17,283,3,230,1382.07,77.0,53
16392,2011-03-15,2011-03-15,269,0,0,221.19000000000003,0.0,269
16393,2010-12-05,2011-12-07,369,12,367,3046.2100000000014,31.0,2
16394,2011-02-23,2011-10-14,289,4,233,1555.3400000000006,58.0,56
16395,2011-01-13,2011-10-10,330,4,270,1486.9000000000003,68.0,60
16398,2011-03-31,2011-07-08,253,1,99,1705.8000000000004,99.0,154
16399,2011-04-18,2011-11-20,235,1,216,408.57,216.0,19
16400,2011-09-06,2011-09-06,94,0,0,303.93,0.0,94
16401,2011-01-16,2011-12-08,327,11,326,4098.319999999999,30.0,1
16402,2010-12-05,2011-03-20,369,1,105,299.59999999999997,105.0,264
16403,2011-01-31,2011-01-31,312,0,0,177.5,0.0,312
16404,2011-09-30,2011-09-30,70,0,0,443.0500000000001,0.0,70
16405,2011-02-02,2011-02-10,310,1,8,167.25,8.0,302
16406,2011-11-21,2011-11-21,18,0,0,163.07,0.0,18
16407,2011-01-31,2011-11-27,312,8,300,2126.9300000000017,38.0,12
16409,2011-01-26,2011-11-03,317,4,281,2028.8800000000017,70.0,36
16411,2010-12-05,2011-11-20,369,1,350,214.65,350.0,19
16412,2011-10-17,2011-10-17,53,0,0,151.83,0.0,53
16413,2011-10-14,2011-10-14,56,0,0,262.20000000000005,0.0,56
16414,2011-03-04,2011-11-18,280,1,259,126.25,259.0,21
16415,2011-10-26,2011-10-26,44,0,0,210.34999999999985,0.0,44
16416,2011-10-14,2011-11-13,56,2,30,1051.3999999999999,15.0,26
16418,2011-04-27,2011-10-26,226,2,182,675.2700000000002,91.0,44
16419,2011-02-01,2011-08-19,311,4,199,972.23,50.0,112
16422,2010-12-05,2011-11-22,369,47,352,34684.400000000016,7.0,17
16423,2011-11-15,2011-11-15,24,0,0,346.12,0.0,24
16424,2011-06-01,2011-06-01,191,0,0,133.56,0.0,191
16425,2011-02-10,2011-02-10,302,0,0,302.69999999999993,0.0,302
16426,2011-03-08,2011-12-07,276,6,274,1908.2500000000002,46.0,2
16427,2011-02-28,2011-03-21,284,1,21,241.06,21.0,263
16429,2011-08-25,2011-08-25,106,0,0,284.55,0.0,106
16430,2011-10-13,2011-10-13,57,0,0,300.85,0.0,57
16431,2011-02-15,2011-05-10,297,1,84,642.81,84.0,213
16432,2011-10-06,2011-10-06,64,0,0,287.40000000000003,0.0,64
16433,2011-11-11,2011-11-11,28,0,0,184.26000000000002,0.0,28
16434,2011-02-13,2011-11-10,299,6,270,1522.2500000000005,45.0,29
16438,2011-09-18,2011-12-04,82,4,77,798.3499999999997,19.0,5
16440,2011-05-09,2011-12-02,214,4,207,3640.669999999999,52.0,7
16441,2011-02-21,2011-10-03,291,1,224,381.20000000000005,224.0,67
16442,2010-12-14,2011-12-08,360,2,359,616.79,180.0,1
16444,2011-03-20,2011-10-24,264,3,218,654.6700000000003,73.0,46
16445,2011-11-06,2011-11-06,33,0,0,230.51000000000002,0.0,33
16446,2011-05-18,2011-12-09,205,1,205,168472.5,205.0,0
16447,2011-07-27,2011-07-27,135,0,0,259.0099999999999,0.0,135
16448,2011-05-25,2011-05-25,198,0,0,188.89,0.0,198
16449,2011-03-04,2011-05-26,280,1,83,707.6899999999999,83.0,197
16450,2011-07-13,2011-07-13,149,0,0,311.92,0.0,149
16451,2011-09-13,2011-09-13,87,0,0,266.97,0.0,87
16454,2011-10-06,2011-10-26,64,1,20,6.9,20.0,44
16455,2010-12-03,2011-10-07,371,5,308,1841.1800000000005,62.0,63
16456,2010-12-01,2011-09-01,373,4,274,2158.3700000000003,68.0,99
16457,2011-05-05,2011-05-05,218,0,0,208.36,0.0,218
16458,2010-12-14,2011-12-07,360,17,358,3482.7400000000002,21.0,2
16460,2011-09-19,2011-11-11,81,2,53,814.7199999999996,26.0,28
16461,2011-06-15,2011-06-15,177,0,0,151.42,0.0,177
16462,2011-03-01,2011-09-27,283,2,210,136.0,105.0,73
16463,2011-05-19,2011-11-18,204,3,183,1422.4,61.0,21
16464,2011-07-20,2011-11-20,142,2,123,1314.6800000000003,62.0,19
16466,2011-02-20,2011-11-06,292,6,259,1603.460000000001,43.0,33
16468,2011-09-26,2011-09-26,74,0,0,74.9,0.0,74
16469,2011-04-07,2011-11-16,246,2,223,650.4300000000004,112.0,23
16470,2010-12-16,2011-10-19,358,3,307,762.39,102.0,51
16471,2011-03-10,2011-03-10,274,0,0,223.95000000000005,0.0,274
16473,2011-01-07,2011-06-28,336,2,172,316.11,86.0,164
16474,2011-07-17,2011-12-02,145,5,138,1871.5000000000025,28.0,7
16475,2011-03-11,2011-09-12,273,3,185,544.3,62.0,88
16477,2010-12-03,2011-10-07,371,6,308,2494.4600000000005,51.0,63
16478,2011-10-05,2011-11-14,65,2,40,331.0,20.0,25
16479,2011-11-29,2011-11-29,10,0,0,300.83,0.0,10
16480,2011-09-25,2011-09-25,75,0,0,769.2899999999995,0.0,75
16482,2011-11-24,2011-11-24,15,0,0,220.62,0.0,15
16483,2011-05-31,2011-05-31,192,0,0,139.35000000000002,0.0,192
16484,2011-06-02,2011-06-19,190,1,17,404.3000000000001,17.0,173
16485,2011-09-23,2011-09-23,77,0,0,363.65,0.0,77
16488,2011-07-14,2011-11-06,148,2,115,498.8,58.0,33
16491,2011-10-24,2011-10-24,46,0,0,731.5,0.0,46
16493,2011-01-14,2011-09-21,329,3,250,1351.6300000000003,83.0,79
16494,2011-02-16,2011-02-16,296,0,0,826.5299999999999,0.0,296
16495,2011-03-08,2011-12-06,276,1,273,684.4100000000003,273.0,3
16496,2011-01-27,2011-12-01,316,2,308,1599.5200000000002,154.0,8
16497,2011-01-10,2011-10-21,333,4,284,2965.690000000001,71.0,49
16498,2011-06-30,2011-07-01,162,1,1,100.97000000000001,1.0,161
16499,2010-12-10,2010-12-14,364,1,4,365.45,4.0,360
16500,2011-01-13,2011-12-05,330,4,326,400.86000000000007,82.0,4
16503,2010-12-14,2011-08-25,360,3,254,1431.9300000000005,85.0,106
16504,2011-11-14,2011-11-14,25,0,0,484.3799999999998,0.0,25
16505,2011-11-08,2011-11-08,31,0,0,777.6,0.0,31
16506,2011-10-30,2011-11-20,40,1,21,90.30000000000001,21.0,19
16509,2011-02-16,2011-02-16,296,0,0,363.70000000000005,0.0,296
16510,2010-12-02,2010-12-02,372,0,0,248.10000000000002,0.0,372
16511,2011-03-18,2011-11-18,266,2,245,950.2599999999999,122.0,21
16513,2011-10-27,2011-12-05,43,3,39,874.5899999999999,13.0,4
16515,2011-02-01,2011-10-18,311,4,259,1627.1300000000006,65.0,52
16516,2011-11-09,2011-11-09,30,0,0,101.7,0.0,30
16517,2011-03-07,2011-03-07,277,0,0,162.70000000000005,0.0,277
16518,2011-02-28,2011-10-09,284,1,223,484.32000000000016,223.0,61
16519,2010-12-09,2011-11-14,365,1,340,215.08,340.0,25
16520,2010-12-09,2011-06-06,365,2,179,1046.5700000000004,90.0,186
16523,2011-01-28,2011-12-08,315,17,314,9418.470000000007,18.0,1
16525,2010-12-08,2011-12-07,366,25,364,13027.450000000008,15.0,2
16526,2011-06-21,2011-06-21,171,0,0,290.35999999999996,0.0,171
16527,2011-09-19,2011-09-19,81,0,0,228.06000000000006,0.0,81
16528,2011-12-06,2011-12-06,3,0,0,244.41000000000003,0.0,3
16529,2011-06-02,2011-06-02,190,0,0,455.25000000000006,0.0,190
16531,2010-12-14,2011-11-17,360,6,338,1244.5900000000001,56.0,22
16532,2011-01-05,2011-11-22,338,2,321,6748.8,160.0,17
16533,2011-10-02,2011-11-20,68,2,49,1095.5600000000006,24.0,19
16535,2011-12-04,2011-12-04,5,0,0,593.75,0.0,5
16536,2011-08-21,2011-08-21,110,0,0,548.97,0.0,110
16539,2010-12-01,2011-12-07,373,3,371,1388.81,124.0,2
16542,2011-10-17,2011-10-17,53,0,0,119.62,0.0,53
16545,2011-06-28,2011-06-28,164,0,0,339.3,0.0,164
16546,2010-12-02,2011-02-22,372,1,82,787.15,82.0,290
16549,2011-01-09,2011-11-29,334,7,324,4154.639999999994,46.0,10
16550,2010-12-06,2011-08-23,368,4,260,2298.9699999999984,65.0,108
16551,2011-01-07,2011-09-05,336,2,241,922.12,120.0,95
16552,2010-12-01,2011-04-11,373,1,131,379.7300000000001,131.0,242
16553,2010-12-14,2011-06-29,360,5,197,5719.819999999999,39.0,163
16554,2011-01-12,2011-10-28,331,2,289,837.1,144.0,42
16555,2011-08-22,2011-11-04,109,1,74,285.89000000000004,74.0,35
16556,2010-12-14,2011-10-04,360,6,294,3313.79,49.0,66
16557,2011-07-25,2011-11-15,137,1,113,281.84999999999997,113.0,24
16558,2010-12-08,2011-12-09,366,19,366,8338.490000000013,19.0,0
16560,2010-12-16,2011-11-13,358,1,332,841.4099999999997,332.0,26
16561,2011-10-11,2011-12-04,59,1,54,511.12000000000006,54.0,5
16563,2011-10-17,2011-10-17,53,0,0,1077.74,0.0,53
16565,2010-12-10,2010-12-10,364,0,0,173.7,0.0,364
16566,2011-02-20,2011-11-24,292,4,277,614.6600000000001,69.0,15
16567,2011-01-07,2011-05-29,336,1,142,865.5999999999999,142.0,194
16569,2011-12-06,2011-12-06,3,0,0,124.2,0.0,3
16570,2011-02-01,2011-11-24,311,8,296,3738.4000000000005,37.0,15
16571,2011-03-03,2011-11-13,281,2,255,1421.6900000000003,128.0,26
16572,2011-03-09,2011-08-04,275,2,148,1009.5999999999999,74.0,127
16573,2011-02-22,2011-09-16,290,1,206,663.6099999999998,206.0,84
16574,2011-09-29,2011-09-29,71,0,0,451.4399999999998,0.0,71
16581,2011-06-10,2011-06-10,182,0,0,105.84,0.0,182
16582,2011-08-18,2011-08-18,113,0,0,313.61999999999995,0.0,113
16583,2010-12-01,2010-12-01,373,0,0,233.45000000000005,0.0,373
16584,2011-03-30,2011-09-20,254,1,174,936.0799999999999,174.0,80
16586,2011-04-05,2011-04-05,248,0,0,463.95,0.0,248
16587,2011-04-21,2011-04-21,232,0,0,225.14999999999998,0.0,232
16589,2011-07-01,2011-09-29,161,2,90,459.23999999999995,45.0,71
16591,2011-10-02,2011-10-02,68,0,0,213.50000000000003,0.0,68
16592,2011-02-25,2011-12-05,287,8,283,4113.679999999999,35.0,4
16593,2011-01-16,2011-10-20,327,2,277,330.0299999999999,138.0,50
16594,2011-09-25,2011-09-25,75,0,0,181.08999999999997,0.0,75
16595,2011-10-09,2011-10-09,61,0,0,360.1600000000003,0.0,61
16596,2010-12-08,2011-11-24,366,1,351,250.15,351.0,15
16597,2011-12-05,2011-12-05,4,0,0,90.04000000000002,0.0,4
16598,2011-02-27,2011-02-27,285,0,0,145.05,0.0,285
16600,2011-01-05,2011-12-05,338,5,334,813.5200000000001,67.0,4
16601,2011-10-30,2011-10-30,40,0,0,244.79999999999995,0.0,40
16602,2011-11-03,2011-11-03,36,0,0,528.0799999999999,0.0,36
16603,2011-09-09,2011-09-26,91,1,17,482.47,17.0,74
16607,2010-12-16,2011-11-22,358,13,341,3347.7100000000014,26.0,17
16609,2011-04-01,2011-11-24,252,6,237,5493.460000000006,40.0,15
16610,2011-05-04,2011-05-04,219,0,0,75.66000000000001,0.0,219
16611,2011-06-06,2011-06-06,186,0,0,129.49,0.0,186
16612,2011-02-01,2011-11-07,311,3,279,1187.6599999999999,93.0,32
16613,2011-09-30,2011-09-30,70,0,0,618.59,0.0,70
16614,2011-06-10,2011-06-10,182,0,0,506.18999999999994,0.0,182
16616,2011-07-05,2011-11-24,157,1,142,500.42000000000013,142.0,15
16617,2011-04-18,2011-04-18,235,0,0,151.85000000000002,0.0,235
16618,2011-01-21,2011-11-08,322,3,291,2647.5900000000015,97.0,31
16619,2011-03-21,2011-03-21,263,0,0,226.21,0.0,263
16620,2011-03-24,2011-12-06,260,1,257,178.96000000000004,257.0,3
16621,2011-03-07,2011-10-19,277,3,226,813.4800000000002,75.0,51
16623,2011-04-08,2011-04-08,245,0,0,129.45000000000002,0.0,245
16624,2011-05-26,2011-09-20,197,1,117,810.5699999999999,117.0,80
16625,2011-03-10,2011-03-10,274,0,0,333.08000000000004,0.0,274
16626,2011-03-18,2011-12-09,266,16,266,4413.100000000002,17.0,0
16627,2011-09-21,2011-09-21,79,0,0,322.8,0.0,79
16628,2011-04-19,2011-11-10,234,4,205,2188.0499999999997,51.0,29
16629,2011-09-04,2011-09-27,96,1,23,417.72999999999985,23.0,73
16633,2011-04-19,2011-11-22,234,5,217,2883.1000000000004,43.0,17
16634,2010-12-02,2011-05-01,372,1,150,217.9,150.0,222
16637,2011-04-28,2011-11-07,225,3,193,1154.4700000000003,64.0,32
16638,2010-12-06,2011-11-17,368,9,346,1680.7199999999998,38.0,22
16639,2011-04-18,2011-11-08,235,2,204,1257.51,102.0,31
16641,2011-08-26,2011-08-26,105,0,0,231.10000000000005,0.0,105
16642,2011-05-16,2011-12-05,207,1,203,688.3300000000002,203.0,4
16643,2011-04-08,2011-04-08,245,0,0,487.51,0.0,245
16644,2011-05-11,2011-06-15,212,1,35,833.7799999999996,35.0,177
16647,2011-05-19,2011-06-23,204,1,35,214.06,35.0,169
16648,2011-10-28,2011-10-28,42,0,0,290.65999999999997,0.0,42
16650,2011-09-29,2011-09-29,71,0,0,518.4200000000001,0.0,71
16652,2011-03-11,2011-10-12,273,4,215,6773.970000000001,54.0,58
16653,2011-09-29,2011-11-23,71,1,55,1212.6600000000005,55.0,16
16654,2010-12-06,2011-07-21,368,3,227,601.2699999999999,76.0,141
16655,2011-01-12,2011-11-22,331,5,314,3794.519999999997,63.0,17
16656,2010-12-10,2011-11-17,364,14,342,8625.8,24.0,22
16657,2011-03-30,2011-11-30,254,3,245,933.6199999999995,82.0,9
16658,2010-12-06,2010-12-06,368,0,0,123.24,0.0,368
16659,2011-06-03,2011-06-03,189,0,0,39.12,0.0,189
16660,2011-01-24,2011-11-23,319,2,303,1267.6499999999999,152.0,16
16665,2010-12-12,2010-12-12,362,0,0,135.4,0.0,362
16666,2011-11-20,2011-11-20,19,0,0,118.98,0.0,19
16667,2011-02-28,2011-10-02,284,1,216,570.1299999999998,216.0,68
16668,2011-02-28,2011-11-24,284,5,269,306.71999999999997,54.0,15
16669,2011-09-22,2011-11-16,78,1,55,1374.8700000000003,55.0,23
16670,2010-12-16,2011-11-23,358,9,342,4095.9000000000024,38.0,16
16671,2011-06-28,2011-11-11,164,2,136,1692.27,68.0,28
16672,2011-03-18,2011-12-07,266,17,264,8134.94,16.0,2
16674,2011-09-02,2011-10-16,98,1,44,319.61000000000007,44.0,54
16676,2011-01-06,2011-11-06,337,3,304,1592.12,101.0,33
16678,2011-03-02,2011-12-07,282,11,280,3109.990000000001,25.0,2
16679,2010-12-08,2010-12-08,366,0,0,129.75,0.0,366
16680,2011-10-27,2011-10-27,43,0,0,183.70000000000002,0.0,43
16681,2011-03-31,2011-09-28,253,5,181,1770.3400000000004,36.0,72
16682,2011-06-05,2011-12-05,187,4,183,1027.9999999999998,46.0,4
16684,2010-12-16,2011-12-05,358,15,354,66653.56,24.0,4
16685,2011-10-09,2011-10-09,61,0,0,324.24,0.0,61
16686,2010-12-19,2011-10-23,355,6,308,3062.8299999999986,51.0,47
16688,2011-10-10,2011-12-08,60,3,59,1260.8600000000001,20.0,1
16689,2011-09-18,2011-09-25,82,1,7,422.59999999999997,7.0,75
16690,2011-05-22,2011-09-28,201,1,129,225.57999999999996,129.0,72
16692,2011-02-23,2011-03-28,289,1,33,1276.0,33.0,256
16693,2011-03-13,2011-10-02,271,1,203,482.0099999999998,203.0,68
16696,2011-04-05,2011-07-27,248,3,113,657.9,38.0,135
16697,2011-04-12,2011-04-12,241,0,0,112.75000000000001,0.0,241
16698,2011-03-31,2011-04-27,253,1,27,1998.0,27.0,226
16700,2010-12-08,2011-12-01,366,12,358,5076.550000000002,30.0,8
16701,2010-12-13,2011-12-01,361,11,353,5398.300000000002,32.0,8
16705,2010-12-16,2011-12-09,358,11,358,14034.989999999989,33.0,0
16706,2011-08-17,2011-11-02,114,2,77,531.35,38.0,37
16708,2011-10-25,2011-10-25,45,0,0,656.6300000000002,0.0,45
16709,2011-03-03,2011-09-16,281,3,197,3029.8700000000013,66.0,84
16710,2010-12-06,2011-11-20,368,8,349,2483.04,44.0,19
16711,2010-12-17,2011-12-06,357,4,354,1651.0299999999995,88.0,3
16712,2011-03-08,2011-11-30,276,8,267,3645.4299999999957,33.0,9
16713,2010-12-08,2011-11-21,366,14,348,6923.130000000008,25.0,18
16714,2011-01-26,2011-05-05,317,1,99,1161.5299999999993,99.0,218
16715,2011-09-22,2011-09-22,78,0,0,301.71999999999997,0.0,78
16716,2011-02-01,2011-03-18,311,1,45,901.2000000000003,45.0,266
16717,2010-12-08,2011-11-16,366,5,343,3858.379999999999,69.0,23
16718,2010-12-05,2010-12-05,369,0,0,623.7500000000002,0.0,369
16719,2010-12-06,2011-11-25,368,6,354,1790.4200000000008,59.0,14
16720,2011-11-13,2011-11-13,26,0,0,155.23999999999998,0.0,26
16721,2011-03-22,2011-03-22,262,0,0,292.47,0.0,262
16722,2010-12-06,2011-11-22,368,12,351,4730.81,29.0,17
16723,2011-08-24,2011-09-09,107,1,16,589.1500000000001,16.0,91
16725,2010-12-03,2011-02-10,371,5,69,781.0200000000003,14.0,302
16726,2010-12-13,2011-11-13,361,3,335,1382.0200000000013,112.0,26
16727,2010-12-10,2010-12-10,364,0,0,272.82,0.0,364
16728,2011-03-20,2011-10-24,264,3,218,1054.6699999999996,73.0,46
16729,2011-04-12,2011-11-01,241,18,203,7239.919999999984,11.0,38
16730,2011-01-24,2011-10-18,319,2,267,743.11,134.0,52
16732,2011-11-08,2011-11-08,31,0,0,603.7499999999999,0.0,31
16734,2011-08-17,2011-10-18,114,1,62,650.51,62.0,52
16735,2011-01-09,2011-09-22,334,3,256,2300.559999999999,85.0,78
16737,2011-10-17,2011-10-17,53,0,0,417.6,0.0,53
16738,2011-02-15,2011-02-15,297,0,0,3.75,0.0,297
16739,2011-06-16,2011-06-16,176,0,0,323.00000000000006,0.0,176
16742,2011-10-24,2011-10-24,46,0,0,464.9,0.0,46
16743,2010-12-16,2011-11-10,358,5,329,2238.0900000000006,66.0,29
16744,2011-06-19,2011-11-28,173,6,162,1304.7599999999993,27.0,11
16745,2011-02-01,2011-09-14,311,16,225,7194.300000000006,14.0,86
16746,2010-12-16,2011-12-05,358,16,354,6697.660000000009,22.0,4
16747,2011-10-03,2011-11-02,67,1,30,836.0600000000001,30.0,37
16748,2011-01-09,2011-11-22,334,4,317,1515.8999999999992,79.0,17
16750,2011-04-21,2011-10-26,232,4,188,623.93,47.0,44
16751,2011-11-09,2011-11-09,30,0,0,1764.7199999999998,0.0,30
16752,2010-12-02,2010-12-02,372,0,0,207.5,0.0,372
16753,2011-10-12,2011-10-12,58,0,0,223.92,0.0,58
16754,2010-12-02,2010-12-02,372,0,0,2002.4,0.0,372
16755,2011-01-28,2011-08-17,315,2,201,1496.8300000000004,100.0,114
16756,2011-05-09,2011-05-09,214,0,0,239.40000000000006,0.0,214
16757,2011-01-25,2011-01-25,318,0,0,106.83000000000001,0.0,318
16758,2011-10-05,2011-10-05,65,0,0,369.34,0.0,65
16759,2011-11-09,2011-12-02,30,1,23,789.79,23.0,7
16761,2011-09-04,2011-09-04,96,0,0,316.61999999999995,0.0,96
16762,2011-07-18,2011-11-20,144,2,125,1501.3799999999997,62.0,19
16763,2011-05-25,2011-05-25,198,0,0,611.85,0.0,198
16764,2011-07-19,2011-12-06,143,12,140,2799.250000000002,12.0,3
16765,2011-02-18,2011-02-18,294,0,0,34.0,0.0,294
16766,2011-03-11,2011-03-11,273,0,0,1145.6000000000001,0.0,273
16767,2011-01-27,2011-11-09,316,7,286,5580.599999999999,41.0,30
16768,2011-03-13,2011-10-23,271,2,224,478.08999999999986,112.0,47
16769,2011-03-24,2011-03-24,260,0,0,380.38999999999993,0.0,260
16770,2010-12-02,2011-10-13,372,4,315,770.1000000000006,79.0,57
16771,2011-01-05,2011-11-06,338,4,305,2246.8100000000013,76.0,33
16773,2011-10-13,2011-10-13,57,0,0,171.59,0.0,57
16774,2011-06-14,2011-10-03,178,3,111,661.5200000000001,37.0,67
16775,2010-12-07,2011-11-29,367,10,357,1695.660000000002,36.0,10
16776,2011-10-10,2011-10-10,60,0,0,388.2799999999999,0.0,60
16777,2011-03-27,2011-09-20,257,1,177,226.35000000000005,177.0,80
16778,2011-03-10,2011-09-26,274,1,200,245.94,200.0,74
16779,2010-12-08,2011-12-07,366,20,364,10629.719999999988,18.0,2
16780,2011-03-25,2011-08-31,259,1,159,425.19,159.0,100
16781,2010-12-02,2010-12-02,372,0,0,311.25,0.0,372
16782,2010-12-09,2011-11-29,365,12,355,2279.9,30.0,10
16784,2011-11-20,2011-11-20,19,0,0,107.6,0.0,19
16788,2011-03-30,2011-08-08,254,1,131,597.4799999999999,131.0,123
16789,2011-12-01,2011-12-01,8,0,0,80.8,0.0,8
16790,2011-11-02,2011-12-06,37,5,34,1545.6199999999997,7.0,3
16791,2011-01-11,2011-11-10,332,5,303,1721.7800000000022,61.0,29
16792,2011-03-02,2011-03-02,282,0,0,110.38000000000001,0.0,282
16793,2011-10-13,2011-10-13,57,0,0,243.83999999999997,0.0,57
16794,2011-06-12,2011-12-08,180,8,179,1222.7100000000012,22.0,1
16795,2010-12-09,2010-12-09,365,0,0,414.88000000000005,0.0,365
16796,2011-09-11,2011-09-11,89,0,0,305.62,0.0,89
16800,2011-11-28,2011-11-28,11,0,0,1201.4900000000002,0.0,11
16801,2011-03-11,2011-06-29,273,3,110,1619.7300000000002,37.0,163
16803,2011-10-05,2011-10-05,65,0,0,332.29999999999995,0.0,65
16804,2011-03-14,2011-11-16,270,1,247,536.99,247.0,23
16805,2010-12-14,2011-06-19,360,1,187,460.58999999999986,187.0,173
16806,2011-04-14,2011-08-28,239,3,136,801.4899999999996,45.0,103
16807,2011-03-14,2011-07-20,270,2,128,1121.59,64.0,142
16808,2011-03-10,2011-09-01,274,1,175,288.42,175.0,99
16809,2011-03-22,2011-11-16,262,4,239,914.69,60.0,23
16810,2011-05-31,2011-05-31,192,0,0,309.54,0.0,192
16811,2011-11-22,2011-12-05,17,1,13,547.0699999999999,13.0,4
16812,2010-12-14,2010-12-14,360,0,0,479.3500000000001,0.0,360
16813,2011-05-19,2011-12-01,204,9,196,1692.9799999999998,22.0,8
16814,2010-12-05,2011-11-25,369,20,355,6509.100000000003,18.0,14
16816,2010-12-16,2011-08-28,358,3,255,417.06000000000006,85.0,103
16817,2010-12-06,2011-12-07,368,8,366,1604.7500000000005,46.0,2
16818,2011-05-18,2011-11-29,205,10,195,3349.57,20.0,10
16820,2011-09-05,2011-09-05,95,0,0,497.61000000000007,0.0,95
16823,2011-04-26,2011-04-26,227,0,0,358.37999999999994,0.0,227
16824,2011-06-28,2011-11-24,164,1,149,460.63999999999993,149.0,15
16825,2011-06-07,2011-11-01,185,1,147,775.1800000000001,147.0,38
16826,2011-10-19,2011-10-19,51,0,0,341.70000000000005,0.0,51
16828,2011-08-19,2011-09-07,112,1,19,128.5,19.0,93
16829,2011-07-06,2011-07-06,156,0,0,197.22000000000003,0.0,156
16830,2011-11-01,2011-11-01,38,0,0,325.91,0.0,38
16832,2011-05-06,2011-06-08,217,2,33,199.15000000000003,16.0,184
16833,2011-01-09,2011-12-08,334,2,333,1106.5299999999997,166.0,1
16834,2011-04-26,2011-04-26,227,0,0,413.46000000000004,0.0,227
16835,2010-12-01,2011-08-03,373,1,245,180.85000000000002,245.0,128
16836,2011-08-15,2011-10-31,116,1,77,251.87000000000006,77.0,39
16837,2011-04-08,2011-11-08,245,8,214,3170.9800000000014,27.0,31
16838,2011-02-24,2011-05-26,288,1,91,588.8500000000001,91.0,197
16839,2010-12-05,2011-12-01,369,31,361,16594.34999999998,12.0,8
16841,2011-02-25,2011-11-03,287,5,251,1869.8200000000004,50.0,36
16842,2011-02-10,2011-08-31,302,2,202,1264.1899999999998,101.0,100
16843,2011-01-16,2011-10-28,327,11,285,10196.570000000007,26.0,42
16846,2011-10-20,2011-10-20,50,0,0,214.32000000000002,0.0,50
16847,2011-10-27,2011-10-27,43,0,0,193.44,0.0,43
16848,2011-10-18,2011-10-18,52,0,0,281.42,0.0,52
16849,2011-06-06,2011-06-06,186,0,0,124.57,0.0,186
16850,2011-01-10,2011-01-10,333,0,0,332.41,0.0,333
16851,2011-10-19,2011-12-05,51,2,47,342.45,24.0,4
16852,2011-06-16,2011-11-29,176,1,166,144.91,166.0,10
16855,2011-10-27,2011-11-16,43,1,20,328.40000000000003,20.0,23
16856,2011-11-25,2011-11-25,14,0,0,35.40000000000001,0.0,14
16858,2010-12-06,2010-12-06,368,0,0,375.69000000000005,0.0,368
16859,2011-03-23,2011-07-18,261,1,117,747.81,117.0,144
16861,2011-07-04,2011-10-11,158,1,99,173.76000000000002,99.0,59
16863,2010-12-08,2011-11-08,366,1,335,502.8,335.0,31
16866,2011-07-01,2011-07-22,161,2,21,207.73999999999998,10.0,140
16869,2011-06-17,2011-11-17,175,3,153,825.4199999999997,51.0,22
16871,2011-03-14,2011-11-17,270,4,248,2812.3399999999997,62.0,22
16872,2011-06-08,2011-09-23,184,2,107,680.0200000000001,54.0,77
16873,2010-12-10,2011-12-05,364,5,360,7123.619999999998,72.0,4
16875,2011-01-04,2011-10-03,339,3,272,2095.53,91.0,67
16877,2011-05-15,2011-11-27,208,5,196,853.7199999999998,39.0,12
16878,2011-09-16,2011-09-16,84,0,0,13.3,0.0,84
16880,2011-06-03,2011-11-09,189,5,159,1519.0800000000004,32.0,30
16881,2011-10-04,2011-10-04,66,0,0,432.0,0.0,66
16882,2011-01-26,2011-10-04,317,2,251,705.1199999999998,126.0,66
16883,2010-12-03,2011-06-05,371,1,184,276.72999999999996,184.0,187
16884,2011-11-02,2011-11-02,37,0,0,429.84,0.0,37
16885,2010-12-17,2011-11-24,357,2,342,471.50999999999965,171.0,15
16887,2011-11-04,2011-11-04,35,0,0,194.88,0.0,35
16889,2011-01-07,2011-05-29,336,2,142,1578.6700000000005,71.0,194
16891,2010-12-03,2011-12-08,371,4,370,809.7000000000002,92.0,1
16892,2011-06-09,2011-12-08,183,3,182,525.5399999999997,61.0,1
16893,2010-12-08,2010-12-08,366,0,0,145.93000000000004,0.0,366
16895,2011-10-06,2011-10-06,64,0,0,219.13999999999996,0.0,64
16897,2011-01-30,2011-02-13,313,1,14,289.7800000000001,14.0,299
16898,2010-12-06,2011-11-13,368,2,342,508.8099999999997,171.0,26
16899,2010-12-14,2011-12-02,360,5,353,1281.5599999999997,71.0,7
16900,2011-10-07,2011-11-23,63,2,47,887.1100000000005,24.0,16
16902,2011-08-15,2011-08-15,116,0,0,1706.88,0.0,116
16903,2011-11-10,2011-11-10,29,0,0,373.24,0.0,29
16904,2010-12-07,2011-12-05,367,14,363,3754.2699999999986,26.0,4
16905,2010-12-03,2011-12-04,371,5,366,3102.4300000000003,73.0,5
16906,2011-04-05,2011-09-19,248,3,167,579.7700000000002,56.0,81
16907,2010-12-09,2011-11-10,365,4,336,981.6500000000001,84.0,29
16909,2011-09-28,2011-09-28,72,0,0,379.14000000000004,0.0,72
16910,2011-09-09,2011-12-05,91,7,87,1510.060000000002,12.0,4
16912,2011-01-20,2011-11-11,323,5,295,2575.380000000001,59.0,28
16913,2011-02-22,2011-02-22,290,0,0,113.44000000000001,0.0,290
16914,2011-11-03,2011-11-03,36,0,0,208.45999999999995,0.0,36
16915,2011-03-01,2011-11-30,283,5,274,621.6800000000001,55.0,9
16916,2010-12-02,2011-11-16,372,1,349,576.2600000000003,349.0,23
16917,2011-03-08,2011-03-08,276,0,0,391.5200000000001,0.0,276
16918,2011-01-26,2011-10-21,317,4,268,1068.8199999999997,67.0,49
16919,2010-12-06,2011-07-06,368,10,212,2596.4499999999994,21.0,156
16921,2011-10-09,2011-10-09,61,0,0,169.79000000000005,0.0,61
16923,2010-12-12,2011-11-27,362,16,350,7247.60999999998,22.0,12
16924,2011-09-16,2011-11-18,84,2,63,846.7499999999998,32.0,21
16926,2010-12-03,2010-12-03,371,0,0,230.25000000000003,0.0,371
16927,2010-12-13,2011-08-16,361,2,246,543.0500000000001,123.0,115
16928,2010-12-01,2011-09-20,373,16,293,2847.599999999998,18.0,80
16929,2011-07-07,2011-12-06,155,6,152,1295.3900000000006,25.0,3
16930,2011-10-02,2011-11-13,68,1,42,380.55000000000007,42.0,26
16931,2010-12-05,2011-12-04,369,19,364,4604.2199999999875,19.0,5
16932,2011-10-17,2011-10-17,53,0,0,161.94,0.0,53
16933,2011-04-14,2011-12-08,239,1,238,563.2299999999998,238.0,1
16934,2011-10-16,2011-10-16,54,0,0,950.93,0.0,54
16936,2011-11-14,2011-11-14,25,0,0,262.68,0.0,25
16938,2011-02-04,2011-12-01,308,3,300,2736.3800000000015,100.0,8
16940,2011-02-23,2011-10-18,289,2,237,3049.880000000001,118.0,52
16942,2011-04-26,2011-11-27,227,7,215,1920.5900000000017,31.0,12
16943,2011-01-25,2011-05-12,318,2,107,816.73,54.0,211
16945,2010-12-16,2011-11-18,358,12,337,4345.500000000007,28.0,21
16947,2011-04-18,2011-04-18,235,0,0,406.48000000000013,0.0,235
16948,2011-01-18,2011-07-24,325,2,187,435.02,94.0,138
16949,2011-01-27,2011-12-06,316,5,313,1286.27,63.0,3
16950,2010-12-07,2011-10-14,367,2,311,1178.5600000000002,156.0,56
16951,2011-02-08,2011-07-28,304,2,170,1277.7500000000014,85.0,134
16952,2011-08-22,2011-08-22,109,0,0,167.61,0.0,109
16953,2011-11-09,2011-11-09,30,0,0,20.8,0.0,30
16954,2010-12-15,2011-12-09,359,7,359,2085.080000000001,51.0,0
16955,2010-12-01,2011-06-08,373,3,189,518.6700000000001,63.0,184
16956,2011-11-22,2011-11-22,17,0,0,308.74,0.0,17
16957,2011-03-03,2011-04-14,281,1,42,416.64000000000004,42.0,239
16959,2011-09-13,2011-09-13,87,0,0,117.35000000000001,0.0,87
16960,2011-04-01,2011-11-01,252,2,214,507.04999999999995,107.0,38
16961,2011-08-15,2011-08-15,116,0,0,234.17,0.0,116
16963,2011-06-05,2011-06-05,187,0,0,110.55000000000001,0.0,187
16965,2011-04-27,2011-04-27,226,0,0,201.19000000000003,0.0,226
16966,2011-04-13,2011-12-01,240,6,232,2154.9700000000003,39.0,8
16967,2011-06-03,2011-06-03,189,0,0,319.0199999999999,0.0,189
16968,2011-08-24,2011-12-05,107,1,103,439.4300000000001,103.0,4
16969,2011-06-01,2011-10-31,191,2,152,650.4100000000002,76.0,39
16971,2011-11-01,2011-11-01,38,0,0,357.20999999999987,0.0,38
16976,2011-03-17,2011-03-17,267,0,0,251.52,0.0,267
16978,2011-09-23,2011-09-23,77,0,0,344.33,0.0,77
16979,2011-02-15,2011-12-06,297,5,294,1852.0000000000005,59.0,3
16980,2011-02-21,2011-03-29,291,1,36,1078.9600000000005,36.0,255
16982,2011-10-10,2011-10-10,60,0,0,384.06,0.0,60
16983,2010-12-05,2011-11-27,369,6,357,1931.2499999999998,60.0,12
16984,2011-08-01,2011-09-12,130,1,42,4481.349999999996,42.0,88
16985,2010-12-16,2011-11-22,358,6,341,5464.120000000001,57.0,17
16986,2011-11-09,2011-11-10,30,1,1,1873.2,1.0,29
16987,2011-05-18,2011-12-06,205,5,202,1625.0500000000004,40.0,3
16988,2011-12-04,2011-12-04,5,0,0,126.12,0.0,5
16989,2011-07-12,2011-12-02,150,5,143,1133.25,29.0,7
16990,2011-05-05,2011-05-05,218,0,0,179.0,0.0,218
16992,2011-02-28,2011-11-29,284,4,274,1614.31,68.0,10
16996,2010-12-21,2011-11-09,353,4,323,1456.9600000000003,81.0,30
16997,2011-01-18,2011-02-24,325,2,37,702.0,18.0,288
16998,2011-02-08,2011-07-13,304,2,155,295.0,78.0,149
16999,2011-09-26,2011-11-16,74,1,51,484.82000000000005,51.0,23
17001,2010-12-16,2011-12-09,358,10,358,3989.5700000000006,36.0,0
17002,2011-02-22,2011-09-15,290,2,205,1493.73,102.0,85
17004,2011-09-08,2011-10-24,92,1,46,1412.9399999999996,46.0,46
17006,2011-09-25,2011-12-05,75,3,71,781.7800000000002,24.0,4
17007,2010-12-17,2011-10-20,357,4,307,889.9300000000001,77.0,50
17010,2011-11-21,2011-11-21,18,0,0,195.36000000000004,0.0,18
17011,2011-11-09,2011-11-09,30,0,0,270.90000000000003,0.0,30
17014,2011-10-04,2011-12-01,66,2,58,586.3299999999998,29.0,8
17015,2011-06-07,2011-11-11,185,2,157,1842.5599999999995,78.0,28
17017,2010-12-02,2011-12-07,372,15,370,8694.26,25.0,2
17018,2011-01-18,2011-10-30,325,1,285,920.0999999999998,285.0,40
17019,2010-12-06,2011-11-28,368,3,357,1272.6100000000013,119.0,11
17022,2011-11-08,2011-11-08,31,0,0,71.0,0.0,31
17024,2011-07-05,2011-10-25,157,2,112,95.85,56.0,45
17025,2010-12-01,2011-10-10,373,1,313,357.77,313.0,60
17026,2010-12-05,2011-06-07,369,1,184,154.83,184.0,185
17027,2011-01-26,2011-09-22,317,4,239,890.2899999999997,60.0,78
17029,2011-04-17,2011-08-21,236,1,126,716.0,126.0,110
17030,2011-10-07,2011-10-07,63,0,0,146.87,0.0,63
17031,2011-07-08,2011-11-28,154,1,143,380.35,143.0,11
17033,2010-12-15,2011-09-14,359,2,273,1030.1399999999999,136.0,86
17034,2011-02-25,2011-11-23,287,2,271,745.5200000000001,136.0,16
17035,2011-02-01,2011-04-08,311,1,66,433.53,66.0,245
17037,2011-09-13,2011-09-13,87,0,0,1267.3199999999997,0.0,87
17038,2011-11-09,2011-11-09,30,0,0,112.40000000000003,0.0,30
17040,2011-07-25,2011-07-25,137,0,0,449.7299999999999,0.0,137
17041,2010-12-14,2011-11-13,360,2,334,1081.5700000000002,167.0,26
17042,2011-04-06,2011-12-07,247,4,245,1044.3800000000003,61.0,2
17043,2011-03-18,2011-11-07,266,3,234,1735.18,78.0,32
17044,2011-11-14,2011-11-14,25,0,0,948.4800000000001,0.0,25
17045,2011-04-06,2011-08-18,247,2,134,339.44,67.0,113
17046,2011-07-05,2011-07-05,157,0,0,642.0199999999999,0.0,157
17047,2011-05-18,2011-09-15,205,1,120,1100.9,120.0,85
17048,2011-01-12,2011-08-14,331,2,214,925.3499999999999,107.0,117
17049,2011-03-09,2011-12-07,275,7,273,5659.980000000006,39.0,2
17050,2011-02-13,2011-09-04,299,5,203,3228.8399999999992,41.0,96
17051,2011-05-29,2011-05-29,194,0,0,247.14,0.0,194
17052,2011-11-11,2011-11-11,28,0,0,413.75000000000006,0.0,28
17053,2011-08-01,2011-08-01,130,0,0,498.48,0.0,130
17054,2011-04-08,2011-11-11,245,4,217,1356.3300000000004,54.0,28
17058,2011-04-14,2011-09-19,239,2,158,1179.8899999999999,79.0,81
17059,2010-12-05,2011-11-10,369,4,340,3095.0399999999995,85.0,29
17060,2011-03-18,2011-03-18,266,0,0,234.24,0.0,266
17061,2011-04-21,2011-09-27,232,8,159,5232.23,20.0,73
17062,2010-12-05,2011-01-30,369,3,56,538.37,19.0,313
17063,2011-02-23,2011-11-18,289,3,268,1461.1399999999996,89.0,21
17064,2011-01-16,2011-10-12,327,2,269,859.3500000000004,134.0,58
17068,2010-12-06,2011-11-27,368,20,356,4552.140000000004,18.0,12
17069,2010-12-01,2011-11-11,373,7,345,2709.7000000000007,49.0,28
17070,2011-08-17,2011-08-17,114,0,0,312.13999999999993,0.0,114
17071,2011-02-03,2011-11-11,309,7,281,2429.0300000000007,40.0,28
17073,2011-08-22,2011-11-22,109,3,92,1446.09,31.0,17
17075,2011-01-26,2011-11-22,317,3,300,834.1200000000002,100.0,17
17076,2010-12-10,2011-11-03,364,2,328,841.0799999999999,164.0,36
17078,2011-11-03,2011-11-03,36,0,0,378.2000000000001,0.0,36
17079,2011-09-22,2011-09-22,78,0,0,118.80000000000003,0.0,78
17080,2011-03-15,2011-11-17,269,1,247,287.62000000000006,247.0,22
17081,2011-10-24,2011-11-14,46,1,21,290.1600000000001,21.0,25
17082,2011-01-25,2011-11-06,318,1,285,2003.8500000000008,285.0,33
17083,2011-02-09,2011-08-22,303,2,194,1405.7799999999993,97.0,109
17084,2011-11-04,2011-11-04,35,0,0,2949.7500000000014,0.0,35
17085,2010-12-12,2011-08-08,362,4,239,1566.6500000000003,60.0,123
17086,2011-10-07,2011-12-02,63,5,56,2050.079999999999,11.0,7
17088,2011-03-31,2011-11-11,253,3,225,1991.009999999999,75.0,28
17090,2010-12-20,2011-12-05,354,6,350,2043.950000000001,58.0,4
17091,2010-12-07,2011-12-07,367,6,365,3827.760000000002,61.0,2
17092,2011-03-07,2011-10-20,277,3,227,1777.7800000000007,76.0,50
17094,2011-01-21,2011-01-21,322,0,0,302.0,0.0,322
17095,2011-01-09,2011-11-17,334,2,312,1324.159999999999,156.0,22
17096,2011-03-23,2011-11-24,261,3,246,1022.1300000000003,82.0,15
17097,2010-12-09,2011-12-07,365,6,363,954.4199999999997,60.0,2
17100,2011-11-21,2011-11-21,18,0,0,971.7400000000001,0.0,18
17101,2011-06-14,2011-11-29,178,3,168,1621.7299999999998,56.0,10
17102,2011-03-23,2011-03-23,261,0,0,25.5,0.0,261
17105,2011-02-06,2011-07-03,306,1,147,665.7800000000004,147.0,159
17107,2011-03-06,2011-11-06,278,4,245,10815.429999999995,61.0,33
17109,2011-04-21,2011-11-10,232,3,203,885.04,68.0,29
17110,2011-06-27,2011-06-27,165,0,0,163.29999999999998,0.0,165
17111,2011-10-23,2011-10-23,47,0,0,248.60999999999999,0.0,47
17114,2011-01-09,2011-12-04,334,7,329,808.6199999999997,47.0,5
17115,2011-04-20,2011-12-01,233,2,225,837.4999999999998,112.0,8
17117,2011-02-24,2011-02-24,288,0,0,116.19999999999997,0.0,288
17118,2011-01-26,2011-01-26,317,0,0,157.02,0.0,317
17119,2011-10-11,2011-12-06,59,1,56,606.91,56.0,3
17120,2011-04-20,2011-04-20,233,0,0,307.46,0.0,233
17122,2011-08-12,2011-08-12,119,0,0,138.32,0.0,119
17123,2011-07-01,2011-07-01,161,0,0,345.30000000000007,0.0,161
17124,2011-06-07,2011-06-07,185,0,0,298.89000000000004,0.0,185
17125,2011-10-20,2011-10-20,50,0,0,259.34999999999997,0.0,50
17126,2010-12-12,2011-07-10,362,2,210,1004.7499999999999,105.0,152
17128,2011-01-09,2011-01-09,334,0,0,157.09,0.0,334
17131,2011-09-25,2011-12-04,75,3,70,2463.170000000001,23.0,5
17133,2011-03-18,2011-11-24,266,5,251,4892.240000000001,50.0,15
17134,2011-03-20,2011-08-25,264,1,158,425.0,158.0,106
17135,2010-12-03,2011-11-23,371,4,355,1139.7299999999998,89.0,16
17138,2011-03-09,2011-03-09,275,0,0,380.5,0.0,275
17139,2011-02-24,2011-11-24,288,8,273,10668.469999999988,34.0,15
17140,2011-04-06,2011-04-06,247,0,0,465.32000000000005,0.0,247
17142,2011-04-14,2011-04-14,239,0,0,579.0,0.0,239
17144,2011-09-16,2011-12-08,84,1,83,984.5699999999998,83.0,1
17146,2010-12-16,2011-08-26,358,2,253,749.78,126.0,105
17147,2011-02-01,2011-11-17,311,3,289,1714.5900000000001,96.0,22
17148,2011-10-19,2011-10-19,51,0,0,124.88000000000001,0.0,51
17152,2011-03-21,2011-05-29,263,1,69,1689.5,69.0,194
17153,2011-11-15,2011-11-15,24,0,0,213.77999999999997,0.0,24
17154,2011-09-25,2011-09-25,75,0,0,329.34000000000003,0.0,75
17155,2011-06-15,2011-11-22,177,1,160,251.69999999999996,160.0,17
17157,2011-06-16,2011-12-02,176,1,169,319.0,169.0,7
17158,2010-12-14,2011-11-07,360,2,328,1266.9699999999993,164.0,32
17159,2011-06-21,2011-11-18,171,2,150,1538.88,75.0,21
17160,2011-04-12,2011-11-08,241,5,210,3518.0299999999993,42.0,31
17162,2011-02-07,2011-11-11,305,5,277,1715.4599999999996,55.0,28
17163,2011-09-22,2011-11-18,78,1,57,293.1,57.0,21
17164,2011-03-11,2011-11-07,273,4,241,2467.350000000001,60.0,32
17165,2011-02-28,2011-02-28,284,0,0,158.68,0.0,284
17166,2011-05-20,2011-11-01,203,1,165,206.33999999999997,165.0,38
17169,2011-06-09,2011-10-13,183,1,126,835.7800000000005,126.0,57
17171,2011-02-23,2011-02-23,289,0,0,224.90999999999997,0.0,289
17172,2011-09-22,2011-09-22,78,0,0,317.76,0.0,78
17173,2011-07-31,2011-12-04,131,6,126,3766.5999999999985,21.0,5
17174,2011-05-06,2011-05-06,217,0,0,59.9,0.0,217
17175,2011-02-16,2011-10-26,296,3,252,1443.6900000000003,84.0,44
17176,2011-05-22,2011-05-22,201,0,0,306.13,0.0,201
17179,2010-12-13,2011-06-14,361,2,183,711.79,92.0,178
17180,2011-01-27,2011-10-14,316,2,260,796.0300000000002,130.0,56
17181,2010-12-01,2011-10-13,373,1,316,239.92,316.0,57
17183,2011-08-26,2011-12-02,105,5,98,3347.3099999999995,20.0,7
17186,2011-10-10,2011-10-24,60,1,14,144.0,14.0,46
17187,2011-04-27,2011-04-27,226,0,0,203.95,0.0,226
17188,2010-12-12,2011-11-28,362,5,351,2474.23,70.0,11
17189,2010-12-15,2011-08-25,359,1,253,384.3999999999999,253.0,106
17190,2011-05-16,2011-10-12,207,1,149,444.74,149.0,58
17191,2010-12-06,2011-11-11,368,4,340,2095.1300000000015,85.0,28
17193,2011-06-16,2011-11-04,176,4,141,1699.3000000000002,35.0,35
17194,2010-12-14,2011-03-11,360,1,87,262.62,87.0,273
17197,2011-11-10,2011-11-10,29,0,0,1013.0100000000001,0.0,29
17198,2010-12-03,2011-11-16,371,2,348,692.2200000000003,174.0,23
17201,2011-10-17,2011-10-17,53,0,0,342.63,0.0,53
17203,2011-10-10,2011-11-04,60,2,25,3563.8499999999995,12.0,35
17204,2011-03-21,2011-06-17,263,2,88,1564.5600000000002,44.0,175
17205,2011-10-17,2011-10-17,53,0,0,384.08,0.0,53
17206,2011-10-17,2011-10-17,53,0,0,204.24,0.0,53
17211,2010-12-05,2011-11-13,369,7,343,2317.220000000001,49.0,26
17212,2011-03-31,2011-03-31,253,0,0,226.85,0.0,253
17213,2010-12-08,2011-10-30,366,5,326,2781.2299999999977,65.0,40
17214,2010-12-15,2011-10-10,359,5,299,1069.12,60.0,60
17217,2011-04-19,2011-04-19,234,0,0,113.5,0.0,234
17218,2010-12-06,2011-12-05,368,9,364,1960.7200000000003,40.0,4
17219,2011-11-08,2011-11-08,31,0,0,114.23,0.0,31
17220,2010-12-10,2011-11-15,364,9,340,3198.2500000000027,38.0,24
17221,2011-11-03,2011-12-02,36,1,29,335.13,29.0,7
17222,2011-10-05,2011-10-05,65,0,0,354.15,0.0,65
17223,2010-12-06,2011-02-02,368,1,58,426.78999999999985,58.0,310
17226,2011-02-04,2011-02-04,308,0,0,393.48999999999995,0.0,308
17227,2010-12-06,2011-11-21,368,5,350,939.32,70.0,18
17228,2010-12-02,2011-11-24,372,7,357,1906.0900000000015,51.0,15
17229,2011-07-20,2011-09-04,142,1,46,318.76000000000005,46.0,96
17230,2010-12-15,2011-03-20,359,3,95,3638.4100000000003,32.0,264
17231,2010-12-13,2011-11-27,361,9,349,3174.3200000000024,39.0,12
17232,2011-11-25,2011-12-07,14,1,12,421.5200000000001,12.0,2
17233,2011-11-04,2011-11-04,35,0,0,190.88,0.0,35
17234,2011-06-10,2011-06-10,182,0,0,149.88999999999996,0.0,182
17235,2010-12-02,2011-11-14,372,1,347,550.0600000000001,347.0,25
17236,2010-12-12,2011-11-27,362,5,350,916.1300000000002,70.0,12
17237,2011-11-17,2011-11-28,22,1,11,314.69,11.0,11
17238,2010-12-03,2011-12-07,371,14,369,3744.65,26.0,2
17239,2011-01-31,2011-01-31,312,0,0,382.50000000000006,0.0,312
17242,2011-06-12,2011-08-23,180,1,72,1135.0399999999997,72.0,108
17243,2010-12-05,2011-12-08,369,25,368,8676.849999999997,15.0,1
17244,2011-10-17,2011-10-17,53,0,0,954.9,0.0,53
17245,2011-05-19,2011-05-19,204,0,0,171.45000000000005,0.0,204
17247,2011-11-24,2011-11-24,15,0,0,282.18999999999994,0.0,15
17248,2011-08-11,2011-08-11,120,0,0,318.65000000000003,0.0,120
17250,2011-03-23,2011-12-06,261,1,258,384.52,258.0,3
17251,2010-12-12,2010-12-12,362,0,0,283.28,0.0,362
17252,2011-06-06,2011-08-15,186,1,70,353.8599999999999,70.0,116
17253,2011-11-21,2011-11-21,18,0,0,178.26,0.0,18
17254,2011-11-24,2011-12-05,15,1,11,272.44000000000005,11.0,4
17255,2011-02-13,2011-10-30,299,1,259,298.40999999999997,259.0,40
17256,2011-01-31,2011-08-24,312,1,205,240.0,205.0,107
17259,2010-12-06,2011-07-14,368,1,220,603.3699999999998,220.0,148
17262,2010-12-08,2011-10-18,366,3,314,1253.3600000000001,105.0,52
17263,2011-05-15,2011-05-15,208,0,0,63.440000000000005,0.0,208
17265,2011-06-12,2011-07-24,180,1,42,562.8999999999997,42.0,138
17266,2011-07-15,2011-12-07,147,2,145,310.63999999999993,72.0,2
17267,2011-08-04,2011-08-04,127,0,0,317.61999999999995,0.0,127
17268,2011-04-08,2011-08-24,245,3,138,763.64,46.0,107
17272,2011-03-22,2011-10-28,262,3,220,2148.6299999999997,73.0,42
17274,2011-11-04,2011-11-04,35,0,0,111.98000000000003,0.0,35
17277,2011-01-21,2011-04-26,322,1,95,1065.3500000000001,95.0,227
17278,2011-04-12,2011-04-12,241,0,0,246.04000000000008,0.0,241
17279,2011-10-13,2011-10-13,57,0,0,187.82999999999998,0.0,57
17282,2011-02-13,2011-08-01,299,2,169,1703.4100000000003,84.0,130
17284,2011-01-07,2011-10-10,336,5,276,1652.580000000002,55.0,60
17286,2011-11-18,2011-11-18,21,0,0,153.92000000000004,0.0,21
17287,2010-12-02,2011-11-13,372,6,346,1064.1100000000001,58.0,26
17288,2010-12-16,2011-11-30,358,6,349,1419.7300000000012,58.0,9
17289,2011-06-12,2011-11-08,180,2,149,944.4100000000004,74.0,31
17290,2011-11-23,2011-12-06,16,1,13,525.2399999999998,13.0,3
17291,2011-02-04,2011-02-04,308,0,0,550.8000000000002,0.0,308
17293,2010-12-13,2011-12-01,361,7,353,1875.1100000000006,50.0,8
17295,2011-10-06,2011-11-11,64,1,36,556.9499999999997,36.0,28
17297,2011-11-22,2011-11-22,17,0,0,131.78000000000006,0.0,17
17298,2011-08-07,2011-08-30,124,1,23,498.42,23.0,101
17299,2011-06-19,2011-11-28,173,3,162,669.1100000000001,54.0,11
17301,2011-11-18,2011-11-18,21,0,0,197.6300000000001,0.0,21
17302,2011-02-07,2011-11-25,305,4,291,1135.6299999999999,73.0,14
17303,2010-12-13,2010-12-13,361,0,0,250.03999999999994,0.0,361
17306,2010-12-21,2011-11-29,353,14,343,8631.310000000003,24.0,10
17309,2011-09-05,2011-09-05,95,0,0,82.75,0.0,95
17311,2011-01-27,2011-09-22,316,1,238,1384.8500000000001,238.0,78
17312,2011-07-03,2011-07-24,159,2,21,644.3,10.0,138
17313,2011-11-08,2011-11-08,31,0,0,2328.8399999999997,0.0,31
17314,2011-01-31,2011-11-15,312,7,288,2527.92,41.0,24
17315,2010-12-17,2011-12-08,357,34,356,6292.259999999996,10.0,1
17317,2011-09-11,2011-10-24,89,2,43,2600.34,22.0,46
17320,2010-12-06,2011-08-31,368,2,268,1200.6199999999997,134.0,100
17321,2011-10-03,2011-12-01,67,1,59,700.8599999999999,59.0,8
17323,2011-02-20,2011-11-24,292,6,277,921.0700000000006,46.0,15
17324,2010-12-08,2011-11-22,366,3,349,990.2300000000002,116.0,17
17325,2011-03-04,2011-03-04,280,0,0,96.8,0.0,280
17329,2011-01-28,2011-11-25,315,1,301,523.11,301.0,14
17330,2011-10-03,2011-11-17,67,1,45,363.90000000000003,45.0,22
17331,2011-08-08,2011-08-08,123,0,0,175.2,0.0,123
17333,2011-09-15,2011-09-15,85,0,0,494.24999999999994,0.0,85
17334,2011-02-04,2011-02-10,308,1,6,307.02000000000004,6.0,302
17337,2011-02-02,2011-07-11,310,3,159,2027.8700000000033,53.0,151
17338,2010-12-13,2011-11-22,361,7,344,6643.929999999995,49.0,17
17339,2010-12-09,2011-09-06,365,1,271,243.36,271.0,94
17340,2010-12-08,2011-11-10,366,7,337,12353.289999999999,48.0,29
17341,2010-12-08,2011-07-06,366,1,210,781.3600000000001,210.0,156
17343,2010-12-19,2010-12-19,355,0,0,193.63999999999996,0.0,355
17344,2011-10-24,2011-10-24,46,0,0,160.56999999999994,0.0,46
17345,2011-05-27,2011-11-24,196,2,181,537.7399999999999,90.0,15
17346,2010-12-01,2011-12-06,373,13,370,2676.559999999999,28.0,3
17347,2011-09-14,2011-09-14,86,0,0,228.96,0.0,86
17348,2011-02-15,2011-11-25,297,4,283,1159.5200000000011,71.0,14
17349,2011-06-13,2011-06-13,179,0,0,110.75,0.0,179
17350,2011-10-19,2011-12-01,51,2,43,1286.0700000000002,22.0,8
17351,2011-03-11,2011-11-03,273,2,237,587.15,118.0,36
17353,2011-07-08,2011-08-02,154,1,25,1740.0,25.0,129
17354,2011-10-20,2011-10-20,50,0,0,1393.06,0.0,50
17356,2011-02-01,2011-02-01,311,0,0,178.21999999999997,0.0,311
17357,2011-11-15,2011-11-15,24,0,0,388.1399999999999,0.0,24
17358,2010-12-19,2011-02-09,355,1,52,365.84999999999985,52.0,303
17359,2011-11-28,2011-11-28,11,0,0,127.85999999999999,0.0,11
17360,2011-06-08,2011-11-22,184,1,167,585.7900000000002,167.0,17
17361,2011-02-21,2011-10-21,291,2,242,488.2,121.0,49
17362,2011-02-03,2011-04-14,309,1,70,312.22999999999996,70.0,239
17364,2011-01-12,2011-12-09,331,9,331,4481.179999999996,37.0,0
17365,2011-01-11,2011-11-27,332,6,320,4801.559999999999,53.0,12
17367,2011-04-15,2011-04-15,238,0,0,168.4,0.0,238
17368,2011-01-06,2011-11-16,337,7,314,1912.6700000000008,45.0,23
17370,2011-06-23,2011-09-28,169,3,97,446.18,32.0,72
17371,2010-12-13,2011-11-22,361,1,344,423.8899999999998,344.0,17
17372,2010-12-12,2011-10-30,362,7,322,1342.6800000000012,46.0,40
17373,2011-01-31,2011-10-30,312,3,272,646.9200000000001,91.0,40
17374,2011-03-03,2011-05-05,281,1,63,495.7699999999999,63.0,218
17375,2010-12-13,2011-05-24,361,2,162,400.09999999999985,81.0,199
17376,2011-02-01,2011-09-30,311,1,241,203.2,241.0,70
17377,2010-12-01,2011-11-16,373,19,350,4100.919999999995,18.0,23
17379,2011-11-28,2011-11-28,11,0,0,404.66,0.0,11
17381,2010-12-02,2011-12-01,372,19,364,20275.60999999999,19.0,8
17382,2011-10-05,2011-10-05,65,0,0,65.4,0.0,65
17383,2011-12-05,2011-12-05,4,0,0,199.29000000000002,0.0,4
17384,2011-05-04,2011-11-20,219,1,200,336.4,200.0,19
17385,2011-11-25,2011-11-25,14,0,0,261.11000000000007,0.0,14
17386,2011-06-27,2011-12-02,165,3,158,2686.42,53.0,7
17387,2011-11-06,2011-11-20,33,1,14,784.11,14.0,19
17388,2011-02-25,2011-09-23,287,3,210,1259.56,70.0,77
17389,2011-01-12,2011-12-09,331,31,331,31833.680000000015,11.0,0
17391,2011-06-28,2011-06-29,164,1,1,508.8,1.0,163
17392,2010-12-16,2011-02-06,358,1,52,457.91,52.0,306
17394,2011-05-04,2011-05-04,219,0,0,203.86999999999992,0.0,219
17396,2010-12-03,2011-10-31,371,3,332,7330.800000000001,111.0,39
17397,2011-11-17,2011-11-17,22,0,0,696.4099999999999,0.0,22
17398,2011-03-29,2011-08-17,255,2,141,653.3799999999999,70.0,114
17400,2010-12-21,2011-08-05,353,4,227,2129.9600000000023,57.0,126
17402,2010-12-05,2011-12-05,369,11,365,2633.8499999999995,33.0,4
17403,2011-11-03,2011-11-03,36,0,0,281.62000000000006,0.0,36
17404,2010-12-14,2011-12-05,360,14,356,31906.819999999992,25.0,4
17405,2011-07-12,2011-12-08,150,2,149,1031.41,74.0,1
17406,2010-12-08,2011-01-10,366,1,33,2200.42,33.0,333
17408,2011-06-29,2011-06-29,163,0,0,32.65,0.0,163
17409,2011-04-05,2011-06-08,248,1,64,771.8499999999999,64.0,184
17410,2011-05-08,2011-11-23,215,4,199,1214.7199999999998,50.0,16
17411,2011-03-23,2011-11-27,261,2,249,778.9399999999999,124.0,12
17412,2010-12-02,2011-12-07,372,6,370,1258.0600000000002,62.0,2
17414,2011-06-08,2011-10-27,184,1,141,778.0,141.0,43
17415,2011-09-21,2011-09-21,79,0,0,507.8399999999999,0.0,79
17416,2011-03-03,2011-11-10,281,6,252,6893.420000000002,42.0,29
17418,2011-01-20,2011-10-28,323,1,281,463.4600000000001,281.0,42
17419,2010-12-07,2011-11-28,367,10,356,4226.57,36.0,11
17420,2010-12-01,2011-10-20,373,2,323,598.8300000000002,162.0,50
17422,2011-02-16,2011-11-23,296,5,280,1979.37,56.0,16
17423,2011-05-06,2011-10-24,217,1,171,698.4100000000003,171.0,46
17425,2011-10-10,2011-11-20,60,1,41,759.1699999999995,41.0,19
17426,2011-03-02,2011-12-01,282,3,274,5037.259999999998,91.0,8
17427,2011-09-29,2011-09-29,71,0,0,100.8,0.0,71
17428,2010-12-06,2011-12-09,368,20,368,17256.850000000002,18.0,0
17429,2011-05-05,2011-08-03,218,2,90,524.9200000000002,45.0,128
17430,2010-12-09,2011-11-07,365,1,333,265.76000000000005,333.0,32
17431,2011-01-30,2011-01-30,313,0,0,403.30000000000007,0.0,313
17432,2011-11-02,2011-11-21,37,1,19,365.76000000000005,19.0,18
17433,2011-09-12,2011-09-12,88,0,0,303.16,0.0,88
17434,2011-09-15,2011-12-07,85,6,83,2373.8200000000006,14.0,2
17436,2011-04-27,2011-12-08,226,1,225,216.30000000000004,225.0,1
17438,2011-03-31,2011-03-31,253,0,0,388.45000000000005,0.0,253
17440,2011-04-06,2011-07-06,247,1,91,186.42,91.0,156
17442,2011-02-22,2011-11-03,290,5,254,2248.560000000001,51.0,36
17443,2011-05-04,2011-05-04,219,0,0,534.24,0.0,219
17444,2011-06-20,2011-07-15,172,2,25,2940.0400000000013,12.0,147
17446,2011-02-02,2011-06-16,310,1,134,120.9,134.0,176
17447,2011-09-29,2011-10-30,71,1,31,541.5300000000001,31.0,40
17449,2010-12-15,2011-12-07,359,5,357,2520.8599999999997,71.0,2
17450,2010-12-07,2011-12-01,367,26,359,194550.79000000007,14.0,8
17451,2011-08-26,2011-12-08,105,4,104,1721.4,26.0,1
17453,2011-10-06,2011-11-22,64,1,47,486.72,47.0,17
17454,2010-12-15,2011-05-31,359,3,167,517.5300000000002,56.0,192
17455,2011-05-20,2011-05-20,203,0,0,131.7,0.0,203
17456,2010-12-09,2010-12-09,365,0,0,249.85999999999999,0.0,365
17457,2011-01-04,2011-08-05,339,4,213,1737.7,53.0,126
17458,2011-11-24,2011-11-24,15,0,0,316.49999999999994,0.0,15
17459,2011-10-10,2011-10-27,60,1,17,657.3,17.0,43
17460,2010-12-01,2011-09-06,373,5,279,622.43,56.0,94
17461,2011-11-10,2011-11-17,29,1,7,757.4599999999996,7.0,22
17462,2011-02-28,2011-10-10,284,1,224,675.6899999999999,224.0,60
17463,2011-01-30,2011-11-23,313,4,297,1896.410000000002,74.0,16
17464,2011-07-04,2011-07-04,158,0,0,289.96000000000004,0.0,158
17466,2011-09-22,2011-11-29,78,1,68,763.2800000000003,68.0,10
17468,2011-11-25,2011-11-29,14,1,4,137.0,4.0,10
17469,2011-05-19,2011-11-23,204,4,188,1870.9699999999996,47.0,16
17470,2010-12-07,2011-10-26,367,4,323,1125.0700000000002,81.0,44
17472,2011-02-13,2011-06-01,299,2,108,710.2900000000002,54.0,191
17475,2011-09-21,2011-09-21,79,0,0,194.36999999999995,0.0,79
17480,2011-09-23,2011-09-23,77,0,0,511.82,0.0,77
17481,2011-09-07,2011-12-06,93,3,90,1255.5900000000006,30.0,3
17483,2011-06-09,2011-10-05,183,2,118,414.0400000000001,59.0,65
17486,2011-03-23,2011-03-23,261,0,0,396.87000000000006,0.0,261
17489,2011-05-11,2011-10-12,212,1,154,376.64,154.0,58
17490,2011-06-16,2011-12-09,176,5,176,2092.3199999999997,35.0,0
17491,2010-12-07,2011-12-08,367,9,366,3558.8700000000003,41.0,1
17492,2011-04-05,2011-04-05,248,0,0,374.57,0.0,248
17495,2011-11-01,2011-12-02,38,1,31,497.56000000000006,31.0,7
17496,2010-12-16,2010-12-16,358,0,0,271.05000000000007,0.0,358
17498,2011-09-25,2011-09-25,75,0,0,272.21999999999997,0.0,75
17499,2011-02-23,2011-02-23,289,0,0,622.88,0.0,289
17500,2011-11-10,2011-11-22,29,2,12,1138.0,6.0,17
17501,2011-05-03,2011-05-03,220,0,0,288.59999999999997,0.0,220
17502,2011-11-10,2011-11-30,29,3,20,689.0999999999999,7.0,9
17503,2011-11-01,2011-12-07,38,1,36,558.9599999999999,36.0,2
17504,2011-01-21,2011-05-17,322,5,116,2997.0300000000007,23.0,206
17505,2011-05-18,2011-07-01,205,1,44,1145.84,44.0,161
17506,2011-09-25,2011-09-25,75,0,0,302.20000000000005,0.0,75
17507,2011-02-03,2011-03-23,309,1,48,605.5799999999999,48.0,261
17508,2011-03-04,2011-03-04,280,0,0,387.31000000000006,0.0,280
17509,2011-10-07,2011-10-13,63,2,6,6115.140000000001,3.0,57
17510,2011-11-15,2011-11-15,24,0,0,308.47999999999996,0.0,24
17511,2010-12-01,2011-12-07,373,27,371,91062.37999999996,14.0,2
17512,2011-02-11,2011-11-11,301,9,273,2924.990000000001,30.0,28
17513,2011-09-28,2011-09-28,72,0,0,513.2,0.0,72
17514,2011-08-03,2011-08-03,128,0,0,208.65,0.0,128
17515,2011-01-25,2011-11-08,318,3,287,639.0199999999998,96.0,31
17516,2011-02-27,2011-11-24,285,3,270,768.0800000000002,90.0,15
17517,2011-02-04,2011-02-04,308,0,0,153.94000000000003,0.0,308
17519,2010-12-06,2011-11-22,368,5,351,1844.0200000000004,70.0,17
17520,2011-10-17,2011-10-17,53,0,0,546.8100000000001,0.0,53
17521,2011-05-24,2011-11-10,199,2,170,723.2099999999998,85.0,29
17522,2011-05-05,2011-12-08,218,4,217,1070.71,54.0,1
17523,2011-11-20,2011-11-28,19,2,8,652.7400000000001,4.0,11
17524,2010-12-13,2010-12-13,361,0,0,145.0,0.0,361
17525,2010-12-15,2010-12-15,359,0,0,422.70000000000005,0.0,359
17526,2010-12-09,2011-12-05,365,3,361,1195.8999999999999,120.0,4
17527,2011-05-05,2011-10-17,218,3,165,939.37,55.0,53
17528,2011-09-29,2011-12-08,71,6,70,3628.5000000000014,12.0,1
17530,2010-12-09,2011-12-08,365,8,364,2385.0000000000023,46.0,1
17531,2011-06-02,2011-06-02,190,0,0,296.70000000000005,0.0,190
17534,2011-10-17,2011-10-17,53,0,0,223.36000000000004,0.0,53
17535,2011-03-04,2011-03-04,280,0,0,164.4,0.0,280
17536,2011-06-15,2011-06-15,177,0,0,76.5,0.0,177
17537,2011-02-09,2011-11-10,303,1,274,897.6200000000005,274.0,29
17538,2011-11-14,2011-11-14,25,0,0,98.42000000000002,0.0,25
17540,2011-01-27,2011-11-15,316,1,292,578.9000000000001,292.0,24
17542,2011-03-15,2011-03-15,269,0,0,170.75,0.0,269
17545,2011-10-27,2011-10-27,43,0,0,645.9599999999999,0.0,43
17548,2011-04-20,2011-04-20,233,0,0,103.3,0.0,233
17549,2011-10-19,2011-11-16,51,1,28,148.86,28.0,23
17550,2011-04-10,2011-05-26,243,1,46,267.16000000000014,46.0,197
17551,2010-12-15,2010-12-15,359,0,0,306.84,0.0,359
17552,2010-12-02,2011-10-10,372,2,312,930.41,156.0,60
17553,2011-08-02,2011-08-02,129,0,0,1487.6,0.0,129
17554,2011-07-14,2011-12-08,148,4,147,1952.4499999999998,37.0,1
17555,2011-01-09,2011-11-20,334,1,315,483.25999999999993,315.0,19
17556,2011-05-18,2011-05-18,205,0,0,157.9,0.0,205
17557,2011-09-19,2011-11-25,81,2,67,541.46,34.0,14
17560,2011-02-02,2011-09-06,310,3,216,854.9500000000002,72.0,94
17561,2011-11-20,2011-11-20,19,0,0,167.61999999999998,0.0,19
17562,2011-06-19,2011-11-25,173,6,159,1122.3799999999999,26.0,14
17564,2011-09-20,2011-11-15,80,2,56,454.0099999999999,28.0,24
17566,2011-11-14,2011-12-01,25,1,17,901.2100000000007,17.0,8
17567,2010-12-02,2011-12-02,372,7,365,4331.48,52.0,7
17569,2011-01-11,2011-01-11,332,0,0,344.13999999999993,0.0,332
17571,2011-02-14,2011-10-20,298,3,248,1498.5100000000014,83.0,50
17572,2010-12-01,2011-09-29,373,3,302,226.75000000000009,101.0,71
17573,2011-09-07,2011-11-10,93,2,64,380.59999999999997,32.0,29
17574,2011-04-11,2011-04-11,242,0,0,185.65000000000006,0.0,242
17576,2010-12-09,2011-12-01,365,17,357,3622.679999999998,21.0,8
17578,2011-05-05,2011-05-05,218,0,0,143.45999999999998,0.0,218
17579,2011-06-13,2011-12-05,179,2,175,448.8999999999999,88.0,4
17580,2010-12-16,2011-04-01,358,2,106,215.72000000000003,53.0,252
17581,2010-12-02,2011-12-09,372,9,372,11045.039999999988,41.0,0
17582,2011-04-17,2011-04-17,236,0,0,175.27,0.0,236
17584,2011-08-04,2011-12-02,127,1,120,1242.3000000000002,120.0,7
17585,2011-01-05,2011-08-22,338,3,229,1133.0700000000004,76.0,109
17588,2011-04-21,2011-08-31,232,2,132,1240.2000000000003,66.0,100
17589,2011-04-13,2011-10-10,240,3,180,2404.170000000001,60.0,60
17590,2011-10-30,2011-12-07,40,2,38,1479.22,19.0,2
17591,2010-12-07,2011-09-27,367,6,294,2225.970000000001,49.0,73
17593,2010-12-22,2011-12-06,352,4,349,3927.3399999999997,87.0,3
17594,2011-03-30,2011-09-15,254,1,169,993.1799999999995,169.0,85
17595,2011-11-02,2011-11-27,37,1,25,388.7900000000001,25.0,12
17596,2010-12-06,2011-11-16,368,6,345,2827.929999999999,58.0,23
17597,2011-05-10,2011-05-10,213,0,0,2044.3700000000003,0.0,213
17600,2011-11-22,2011-11-22,17,0,0,161.67,0.0,17
17601,2011-04-14,2011-04-14,239,0,0,116.01,0.0,239
17602,2011-01-19,2011-12-07,324,5,322,5102.969999999997,64.0,2
17603,2011-09-22,2011-09-22,78,0,0,394.72,0.0,78
17604,2011-01-31,2011-05-06,312,1,95,309.36,95.0,217
17608,2011-11-06,2011-11-06,33,0,0,193.42000000000007,0.0,33
17609,2011-01-16,2011-10-30,327,3,287,1112.2200000000005,96.0,40
17611,2010-12-13,2011-12-02,361,13,354,3984.2199999999993,27.0,7
17612,2011-02-15,2011-10-17,297,5,244,2048.4499999999994,49.0,53
17613,2011-02-07,2011-11-17,305,10,283,4559.15,28.0,22
17614,2011-10-13,2011-10-13,57,0,0,390.0699999999999,0.0,57
17615,2011-05-01,2011-08-01,222,2,92,329.6000000000001,46.0,130
17616,2010-12-07,2011-06-19,367,2,194,571.2,97.0,173
17618,2010-12-12,2011-12-04,362,2,357,971.5800000000002,178.0,5
17619,2011-01-31,2011-01-31,312,0,0,218.52000000000004,0.0,312
17620,2011-10-11,2011-10-11,59,0,0,81.44,0.0,59
17621,2010-12-20,2011-11-18,354,2,333,1379.9,166.0,21
17623,2011-11-07,2011-11-07,32,0,0,527.05,0.0,32
17624,2011-05-05,2011-11-25,218,1,204,843.4799999999997,204.0,14
17625,2011-03-27,2011-11-21,257,3,239,2047.0000000000011,80.0,18
17628,2011-09-19,2011-09-19,81,0,0,75.75000000000001,0.0,81
17629,2010-12-15,2011-12-04,359,7,354,1814.1200000000008,51.0,5
17630,2011-04-21,2011-06-23,232,1,63,503.5999999999999,63.0,169
17631,2011-04-21,2011-12-08,232,2,231,528.33,116.0,1
17633,2011-08-11,2011-11-08,120,3,89,1324.84,30.0,31
17634,2011-01-06,2011-11-03,337,8,301,2361.9700000000034,38.0,36
17636,2011-11-20,2011-11-20,19,0,0,285.56,0.0,19
17637,2011-08-16,2011-11-08,115,1,84,547.06,84.0,31
17639,2011-03-08,2011-03-08,276,0,0,108.5,0.0,276
17640,2011-09-14,2011-09-14,86,0,0,621.6600000000001,0.0,86
17642,2011-06-16,2011-08-12,176,1,57,712.2900000000002,57.0,119
17643,2010-12-01,2010-12-01,373,0,0,101.55,0.0,373
17644,2011-03-24,2011-12-08,260,7,259,2895.6399999999994,37.0,1
17646,2010-12-09,2011-05-04,365,2,146,1008.3899999999999,73.0,219
17647,2011-10-05,2011-10-05,65,0,0,133.06,0.0,65
17648,2011-04-04,2011-10-10,249,2,189,1797.5,94.0,60
17649,2011-07-24,2011-07-24,138,0,0,868.4900000000001,0.0,138
17650,2011-11-18,2011-11-18,21,0,0,166.07999999999998,0.0,21
17651,2011-06-15,2011-11-28,177,8,166,3945.000000000001,21.0,11
17652,2011-03-03,2011-11-14,281,11,256,4867.7199999999975,23.0,25
17653,2011-08-11,2011-11-03,120,3,84,1207.5600000000002,28.0,36
17654,2011-03-07,2011-03-07,277,0,0,117.55,0.0,277
17655,2010-12-08,2011-11-29,366,6,356,2638.9400000000023,59.0,10
17656,2011-08-03,2011-09-27,128,4,55,1674.6900000000003,14.0,73
17658,2011-05-12,2011-11-14,211,1,186,595.42,186.0,25
17659,2010-12-02,2011-11-22,372,11,355,2999.460000000001,32.0,17
17660,2011-07-21,2011-07-21,141,0,0,196.0,0.0,141
17663,2011-02-25,2011-11-14,287,6,262,1802.91,44.0,25
17664,2011-05-11,2011-11-21,212,1,194,604.64,194.0,18
17666,2011-10-05,2011-12-06,65,1,62,728.1599999999999,62.0,3
17667,2011-02-14,2011-10-04,298,3,232,2055.5099999999993,77.0,66
17668,2011-11-01,2011-12-08,38,1,37,347.75,37.0,1
17669,2011-04-04,2011-10-28,249,6,207,3406.7200000000003,34.0,42
17670,2011-04-26,2011-04-26,227,0,0,205.70000000000002,0.0,227
17671,2010-12-09,2011-11-24,365,3,350,1572.7100000000005,117.0,15
17672,2011-02-03,2011-10-20,309,1,259,3178.1700000000005,259.0,50
17673,2011-01-23,2011-12-08,320,5,319,1629.1200000000017,64.0,1
17674,2010-12-06,2011-09-26,368,1,294,551.0400000000001,294.0,74
17675,2010-12-07,2011-12-08,367,28,366,20374.27999999997,13.0,1
17676,2010-12-08,2011-12-05,366,5,362,1387.6800000000005,72.0,4
17677,2010-12-06,2011-12-08,368,17,367,16363.229999999998,22.0,1
17678,2011-03-21,2011-03-21,263,0,0,298.11,0.0,263
17679,2011-09-15,2011-10-18,85,1,33,1992.1100000000006,33.0,52
17680,2011-11-16,2011-11-16,23,0,0,184.4,0.0,23
17682,2010-12-06,2011-11-29,368,5,358,2474.3300000000004,72.0,10
17684,2011-10-27,2011-10-27,43,0,0,239.41,0.0,43
17685,2010-12-02,2011-11-23,372,6,356,3191.5299999999993,59.0,16
17686,2011-02-10,2011-12-02,302,4,295,5739.460000000007,74.0,7
17690,2010-12-01,2011-11-09,373,13,343,4757.950000000001,26.0,30
17691,2010-12-06,2010-12-16,368,1,10,290.40000000000003,10.0,358
17692,2010-12-15,2011-08-04,359,3,232,740.9399999999999,77.0,127
17693,2011-07-25,2011-07-25,137,0,0,200.47,0.0,137
17694,2011-07-21,2011-07-21,141,0,0,283.12000000000006,0.0,141
17695,2011-06-21,2011-07-31,171,1,40,765.3400000000001,40.0,131
17696,2010-12-10,2011-11-01,364,6,326,2285.7100000000014,54.0,38
17697,2011-04-17,2011-04-17,236,0,0,338.95000000000005,0.0,236
17698,2011-03-24,2011-03-24,260,0,0,154.95000000000002,0.0,260
17700,2011-03-03,2011-11-23,281,3,265,2534.64,88.0,16
17701,2011-04-01,2011-04-01,252,0,0,417.95000000000005,0.0,252
17702,2011-05-17,2011-11-09,206,3,176,1824.3700000000001,59.0,30
17703,2011-07-24,2011-11-04,138,2,103,798.7399999999999,52.0,35
17704,2011-04-14,2011-06-24,239,1,71,885.1899999999998,71.0,168
17705,2011-02-11,2011-12-06,301,8,298,1823.5199999999993,37.0,3
17706,2010-12-08,2011-12-05,366,11,362,10504.489999999994,33.0,4
17707,2011-01-07,2011-06-07,336,1,151,152.4,151.0,185
17708,2011-01-19,2011-06-05,324,1,137,267.08000000000004,137.0,187
17709,2011-06-23,2011-06-23,169,0,0,137.45,0.0,169
17711,2011-02-23,2011-11-29,289,1,279,385.10000000000014,279.0,10
17712,2011-10-26,2011-10-26,44,0,0,522.91,0.0,44
17714,2011-01-23,2011-01-23,320,0,0,153.0,0.0,320
17715,2011-05-23,2011-05-23,200,0,0,326.4,0.0,200
17716,2011-03-17,2011-11-17,267,8,245,5655.990000000002,31.0,22
17718,2011-04-21,2011-04-21,232,0,0,139.35,0.0,232
17719,2011-03-29,2011-11-02,255,14,218,5396.040000000004,16.0,37
17720,2010-12-07,2011-11-13,367,3,341,1195.94,114.0,26
17722,2010-12-08,2011-09-04,366,3,270,2424.0399999999995,90.0,96
17723,2011-05-09,2011-08-04,214,5,87,3276.4,17.0,127
17724,2011-07-24,2011-09-29,138,2,67,1033.0000000000005,34.0,71
17725,2011-03-17,2011-11-23,267,10,251,3439.0800000000004,25.0,16
17727,2011-11-24,2011-11-24,15,0,0,1060.25,0.0,15
17728,2011-09-14,2011-12-06,86,2,83,2876.010000000001,42.0,3
17730,2011-01-17,2011-12-06,326,12,323,5298.479999999997,27.0,3
17731,2011-06-09,2011-09-21,183,2,104,1240.11,52.0,79
17732,2010-12-02,2010-12-02,372,0,0,303.97,0.0,372
17733,2011-03-23,2011-11-01,261,1,223,692.1899999999999,223.0,38
17734,2011-04-20,2011-10-17,233,2,180,700.63,90.0,53
17735,2010-12-07,2011-12-07,367,17,365,13110.019999999991,21.0,2
17736,2011-08-18,2011-11-30,113,2,104,377.4399999999999,52.0,9
17737,2011-10-12,2011-11-30,58,1,49,168.24,49.0,9
17738,2011-03-02,2011-11-20,282,2,263,1879.0500000000002,132.0,19
17739,2010-12-14,2011-11-28,360,6,349,2791.3500000000004,58.0,11
17742,2011-01-11,2011-08-18,332,1,219,355.1100000000001,219.0,113
17744,2010-12-16,2011-12-06,358,5,355,2322.3999999999996,71.0,3
17746,2011-04-13,2011-04-13,240,0,0,110.25000000000001,0.0,240
17747,2011-08-19,2011-08-19,112,0,0,71.4,0.0,112
17749,2011-03-28,2011-06-14,256,1,78,674.5199999999999,78.0,178
17750,2011-06-28,2011-12-04,164,8,159,1797.5699999999997,20.0,5
17752,2010-12-15,2010-12-15,359,0,0,80.64,0.0,359
17754,2011-03-24,2011-12-09,260,4,260,1772.259999999999,65.0,0
17757,2010-12-02,2011-12-08,372,29,371,5605.289999999994,13.0,1
17758,2011-04-03,2011-11-20,250,5,231,3456.7000000000025,46.0,19
17759,2011-06-23,2011-11-22,169,1,152,834.9899999999998,152.0,17
17760,2010-12-01,2011-11-18,373,1,352,287.59,352.0,21
17761,2011-11-07,2011-11-07,32,0,0,712.78,0.0,32
17763,2011-03-21,2011-03-21,263,0,0,15.0,0.0,263
17764,2011-05-12,2011-10-20,211,1,161,818.8200000000002,161.0,50
17765,2011-03-28,2011-07-04,256,2,98,371.87999999999994,49.0,158
17767,2011-11-24,2011-11-24,15,0,0,271.20000000000005,0.0,15
17768,2011-06-26,2011-12-01,166,2,158,2273.1800000000007,79.0,8
17769,2011-01-23,2011-11-27,320,9,308,3997.979999999999,34.0,12
17770,2011-03-02,2011-05-25,282,3,84,1143.2699999999995,28.0,198
17771,2011-01-20,2011-10-14,323,1,267,245.81,267.0,56
17772,2011-11-29,2011-11-29,10,0,0,182.76999999999998,0.0,10
17774,2011-02-07,2011-09-04,305,3,209,1225.4100000000003,70.0,96
17775,2011-03-30,2011-03-30,254,0,0,56.4,0.0,254
17777,2011-08-31,2011-11-15,100,2,76,665.86,38.0,24
17779,2011-07-19,2011-11-18,143,2,122,658.5699999999999,61.0,21
17781,2011-03-31,2011-07-03,253,1,94,188.01999999999998,94.0,159
17783,2011-04-06,2011-09-28,247,1,175,283.4699999999997,175.0,72
17785,2011-10-17,2011-10-17,53,0,0,131.94,0.0,53
17786,2011-01-26,2011-09-15,317,1,232,278.74,232.0,85
17787,2010-12-03,2011-07-10,371,3,219,1865.1899999999996,73.0,152
17788,2011-08-02,2011-09-27,129,1,56,1117.9,56.0,73
17789,2011-03-03,2011-03-03,281,0,0,225.9,0.0,281
17790,2010-12-10,2011-11-13,364,11,338,1965.5500000000013,31.0,26
17791,2011-11-10,2011-11-10,29,0,0,106.1,0.0,29
17793,2011-11-14,2011-11-14,25,0,0,323.03999999999996,0.0,25
17795,2011-03-20,2011-06-13,264,1,85,350.3899999999999,85.0,179
17796,2010-12-05,2011-10-30,369,3,329,697.9000000000002,110.0,40
17797,2011-06-10,2011-11-17,182,1,160,780.4300000000003,160.0,22
17799,2010-12-13,2011-11-17,361,8,339,3055.9299999999967,42.0,22
17800,2011-01-09,2011-11-02,334,8,297,1199.01,37.0,37
17802,2010-12-02,2011-09-18,372,2,290,1285.0399999999997,145.0,82
17805,2011-09-27,2011-09-27,73,0,0,512.31,0.0,73
17806,2011-11-28,2011-11-28,11,0,0,546.0399999999998,0.0,11
17809,2010-12-01,2011-11-23,373,9,357,5411.910000000001,40.0,16
17811,2011-01-10,2011-12-05,333,37,329,7837.72999999999,9.0,4
17812,2010-12-06,2011-11-27,368,3,356,732.1600000000001,119.0,12
17813,2011-09-29,2011-11-25,71,4,57,1770.8800000000026,14.0,14
17816,2010-12-09,2011-11-03,365,3,329,36.55999999999999,110.0,36
17817,2011-03-07,2011-12-05,277,1,273,387.67999999999995,273.0,4
17819,2010-12-03,2011-09-29,371,6,300,3704.869999999999,50.0,71
17824,2011-10-19,2011-10-19,51,0,0,298.4,0.0,51
17827,2010-12-10,2011-12-04,364,2,359,1995.460000000001,180.0,5
17828,2011-06-08,2011-11-17,184,3,162,1820.0900000000006,54.0,22
17829,2011-02-14,2011-02-14,298,0,0,889.24,0.0,298
17830,2011-02-24,2011-12-08,288,2,287,398.7,144.0,1
17831,2011-11-06,2011-11-06,33,0,0,35.40000000000001,0.0,33
17832,2011-10-21,2011-10-21,49,0,0,155.3700000000001,0.0,49
17835,2011-11-16,2011-12-07,23,2,21,350.63999999999993,10.0,2
17836,2011-10-23,2011-10-23,47,0,0,110.21000000000001,0.0,47
17837,2011-06-29,2011-10-28,163,7,121,1593.3800000000008,17.0,42
17838,2010-12-02,2011-11-13,372,4,346,2779.2999999999997,86.0,26
17839,2011-10-28,2011-10-28,42,0,0,338.80000000000007,0.0,42
17841,2010-12-01,2011-12-08,373,111,372,40991.57000000008,3.0,1
17843,2011-02-09,2011-02-09,303,0,0,205.48000000000002,0.0,303
17844,2011-08-25,2011-08-25,106,0,0,51.56,0.0,106
17846,2011-09-15,2011-09-15,85,0,0,2033.1,0.0,85
17848,2010-12-16,2011-09-19,358,8,277,901.2000000000003,35.0,81
17849,2011-01-10,2011-05-05,333,3,115,605.8,38.0,218
17850,2010-12-01,2010-12-02,373,1,1,5391.210000000009,1.0,372
17852,2011-11-28,2011-11-28,11,0,0,114.34,0.0,11
17854,2011-04-26,2011-06-07,227,1,42,311.26,42.0,185
17855,2010-12-02,2010-12-02,372,0,0,208.97,0.0,372
17856,2011-03-03,2011-12-08,281,3,280,1418.0300000000002,93.0,1
17857,2010-12-09,2011-12-05,365,19,361,26879.039999999997,19.0,4
17858,2010-12-05,2011-12-04,369,11,364,5155.659999999998,33.0,5
17859,2011-02-08,2011-02-08,304,0,0,148.21,0.0,304
17860,2010-12-06,2010-12-06,368,0,0,252.79999999999998,0.0,368
17861,2011-01-24,2011-12-06,319,6,316,2100.8,53.0,3
17862,2011-01-20,2011-01-20,323,0,0,330.9,0.0,323
17863,2010-12-05,2011-10-11,369,5,310,3159.9999999999995,62.0,59
17864,2011-03-09,2011-11-27,275,2,263,597.5000000000002,132.0,12
17865,2010-12-10,2011-11-09,364,15,334,10526.319999999998,22.0,30
17866,2011-07-20,2011-07-20,142,0,0,329.65000000000003,0.0,142
17867,2011-02-24,2011-11-09,288,3,258,1197.1000000000004,86.0,30
17869,2010-12-06,2011-08-24,368,3,261,428.1799999999999,87.0,107
17870,2010-12-08,2011-12-07,366,8,364,1894.3500000000017,46.0,2
17871,2011-05-19,2011-05-19,204,0,0,155.89999999999998,0.0,204
17873,2010-12-01,2011-09-20,373,4,293,1859.1600000000005,73.0,80
17874,2011-03-29,2011-06-07,255,2,70,683.4600000000003,35.0,185
17877,2011-06-22,2011-06-22,170,0,0,237.61,0.0,170
17878,2011-10-27,2011-10-27,43,0,0,379.45000000000005,0.0,43
17879,2011-06-19,2011-06-19,173,0,0,178.52,0.0,173
17880,2010-12-10,2010-12-10,364,0,0,458.9199999999999,0.0,364
17881,2011-02-08,2011-02-08,304,0,0,133.35,0.0,304
17883,2011-04-07,2011-12-06,246,3,243,671.7699999999994,81.0,3
17884,2010-12-03,2011-12-06,371,3,368,717.4499999999994,123.0,3
17885,2011-11-27,2011-11-27,12,0,0,190.18999999999997,0.0,12
17886,2011-04-04,2011-11-08,249,2,218,899.6099999999999,109.0,31
17887,2011-08-02,2011-08-02,129,0,0,111.35,0.0,129
17888,2010-12-17,2011-11-18,357,7,336,726.0500000000001,48.0,21
17889,2011-01-21,2011-05-11,322,1,110,203.87,110.0,212
17890,2010-12-13,2011-01-21,361,1,39,602.0900000000005,39.0,322
17891,2011-06-30,2011-06-30,162,0,0,203.85999999999993,0.0,162
17892,2011-07-07,2011-10-14,155,2,99,244.10000000000002,50.0,56
17893,2011-04-28,2011-04-28,225,0,0,112.25000000000004,0.0,225
17894,2010-12-08,2011-09-29,366,7,295,1119.8100000000004,42.0,71
17895,2011-10-26,2011-10-26,44,0,0,97.99999999999997,0.0,44
17896,2011-11-16,2011-11-16,23,0,0,256.32,0.0,23
17897,2010-12-01,2011-06-20,373,2,201,566.5999999999999,100.0,172
17898,2011-05-16,2011-09-15,207,1,122,152.06,122.0,85
17899,2011-07-03,2011-07-03,159,0,0,155.79999999999998,0.0,159
17900,2011-06-02,2011-06-02,190,0,0,112.19999999999999,0.0,190
17901,2011-11-10,2011-11-10,29,0,0,110.38000000000001,0.0,29
17904,2011-11-18,2011-11-18,21,0,0,191.66999999999993,0.0,21
17905,2010-12-01,2011-09-29,373,3,302,800.24,101.0,71
17906,2011-04-06,2011-04-06,247,0,0,72.9,0.0,247
17908,2010-12-01,2010-12-01,373,0,0,243.2799999999999,0.0,373
17911,2011-11-30,2011-11-30,9,0,0,366.23,0.0,9
17912,2010-12-10,2011-02-02,364,3,54,311.01000000000005,18.0,310
17913,2010-12-19,2011-10-12,355,1,297,411.6,297.0,58
17914,2011-12-06,2011-12-06,3,0,0,336.4299999999999,0.0,3
17917,2010-12-12,2011-10-25,362,2,317,341.2799999999999,158.0,45
17919,2011-09-12,2011-09-12,88,0,0,1304.04,0.0,88
17920,2010-12-01,2011-12-05,373,16,369,4204.0999999999885,23.0,4
17921,2011-03-18,2011-10-06,266,3,202,826.5200000000003,67.0,64
17923,2011-03-02,2011-03-02,282,0,0,207.50000000000003,0.0,282
17924,2010-12-01,2011-11-28,373,4,362,2962.5000000000005,90.0,11
17925,2010-12-02,2010-12-02,372,0,0,244.08,0.0,372
17926,2011-05-20,2011-07-29,203,1,70,397.29,70.0,133
17928,2011-04-07,2011-10-25,246,1,201,212.54000000000002,201.0,45
17929,2011-02-04,2011-11-28,308,3,297,843.0,99.0,11
17930,2011-04-14,2011-11-04,239,4,204,1740.4799999999998,51.0,35
17931,2011-03-29,2011-07-28,255,1,121,408.36,121.0,134
17932,2011-05-12,2011-11-10,211,2,182,1331.57,91.0,29
17934,2011-10-12,2011-10-19,58,1,7,704.25,7.0,51
17935,2011-07-21,2011-07-24,141,1,3,145.79,3.0,138
17936,2011-12-04,2011-12-04,5,0,0,389.8399999999999,0.0,5
17937,2010-12-12,2011-12-01,362,6,354,4301.22,59.0,8
17939,2011-07-03,2011-07-03,159,0,0,99.14000000000003,0.0,159
17940,2011-02-10,2011-10-21,302,8,253,4106.4400000000005,32.0,49
17941,2011-08-01,2011-08-01,130,0,0,304.56,0.0,130
17942,2011-12-02,2011-12-02,7,0,0,77.50000000000003,0.0,7
17946,2011-03-25,2011-04-20,259,1,26,149.58,26.0,233
17947,2011-11-02,2011-11-02,37,0,0,176.68,0.0,37
17948,2011-07-15,2011-07-15,147,0,0,358.56000000000006,0.0,147
17949,2010-12-03,2011-12-08,371,28,370,58510.48,13.0,1
17950,2010-12-09,2011-09-28,365,1,293,482.20000000000005,293.0,72
17951,2010-12-01,2011-10-31,373,2,334,1008.5400000000004,167.0,39
17954,2010-12-03,2011-12-04,371,11,366,2332.7200000000007,33.0,5
17955,2011-05-04,2011-05-25,219,2,21,557.3,10.0,198
17956,2011-04-04,2011-04-04,249,0,0,12.75,0.0,249
17957,2011-10-04,2011-10-04,66,0,0,111.67999999999998,0.0,66
17958,2011-08-15,2011-08-15,116,0,0,508.46000000000004,0.0,116
17960,2011-06-21,2011-06-21,171,0,0,73.78,0.0,171
17961,2010-12-02,2011-11-18,372,34,351,1296.4400000000012,10.0,21
17962,2011-07-20,2011-07-20,142,0,0,102.82999999999998,0.0,142
17964,2010-12-02,2011-11-08,372,1,341,471.6999999999999,341.0,31
17965,2010-12-05,2011-11-02,369,12,332,2622.569999999998,28.0,37
17966,2011-03-23,2011-11-02,261,3,224,1098.43,75.0,37
17967,2010-12-03,2010-12-03,371,0,0,123.07000000000002,0.0,371
17968,2010-12-01,2010-12-01,373,0,0,277.34999999999997,0.0,373
17969,2010-12-13,2011-06-26,361,1,195,228.2,195.0,166
17970,2011-05-12,2011-05-12,211,0,0,582.5899999999999,0.0,211
17972,2011-04-12,2011-04-12,241,0,0,136.04,0.0,241
17973,2011-10-19,2011-10-19,51,0,0,337.04,0.0,51
17974,2011-05-04,2011-11-15,219,2,195,740.7899999999995,98.0,24
17975,2010-12-08,2011-11-24,366,12,351,4488.810000000001,29.0,15
17976,2010-12-02,2010-12-02,372,0,0,353.18999999999994,0.0,372
17977,2011-11-10,2011-11-10,29,0,0,288.14,0.0,29
17978,2010-12-09,2010-12-09,365,0,0,300.92,0.0,365
17979,2011-03-25,2011-11-04,259,2,224,757.71,112.0,35
17980,2010-12-15,2011-06-27,359,2,194,811.4499999999999,97.0,165
17984,2011-07-17,2011-07-17,145,0,0,152.68000000000006,0.0,145
17985,2011-11-17,2011-11-17,22,0,0,634.9499999999999,0.0,22
17986,2011-10-14,2011-10-14,56,0,0,20.8,0.0,56
17987,2011-06-07,2011-06-07,185,0,0,198.57,0.0,185
17988,2011-01-17,2011-11-28,326,4,315,201.11999999999998,79.0,11
17990,2010-12-13,2011-04-17,361,2,125,630.8400000000001,62.0,236
17991,2011-04-27,2011-04-28,226,1,1,93.35,1.0,225
17994,2011-02-22,2011-08-10,290,3,169,678.4900000000001,56.0,121
17995,2011-03-03,2011-03-03,281,0,0,76.1,0.0,281
17997,2011-06-28,2011-09-26,164,7,90,1970.6700000000023,13.0,74
17999,2010-12-08,2011-11-02,366,1,329,382.05999999999995,329.0,37
18001,2011-09-14,2011-11-27,86,1,74,417.23,74.0,12
18004,2010-12-12,2010-12-12,362,0,0,169.46999999999994,0.0,362
18005,2011-10-23,2011-12-06,47,1,44,249.71999999999989,44.0,3
18006,2011-11-16,2011-11-16,23,0,0,444.68,0.0,23
18008,2011-01-25,2011-09-30,318,7,248,2116.19,35.0,70
18009,2011-04-18,2011-04-18,235,0,0,257.34000000000003,0.0,235
18010,2011-03-28,2011-03-28,256,0,0,174.79999999999998,0.0,256
18011,2010-12-01,2010-12-01,373,0,0,102.79,0.0,373
18013,2011-07-07,2011-07-07,155,0,0,187.29000000000002,0.0,155
18014,2011-11-11,2011-11-11,28,0,0,166.42000000000002,0.0,28
18015,2011-12-05,2011-12-05,4,0,0,120.03,0.0,4
18016,2010-12-10,2011-11-07,364,4,332,1483.56,83.0,32
18017,2011-02-02,2011-09-19,310,2,229,523.0,114.0,81
18018,2011-05-24,2011-08-23,199,1,91,122.13999999999996,91.0,108
18019,2011-10-19,2011-10-19,51,0,0,38.45,0.0,51
18022,2011-11-04,2011-11-04,35,0,0,668.1100000000002,0.0,35
18024,2011-07-10,2011-07-10,152,0,0,389.78000000000003,0.0,152
18027,2011-09-02,2011-09-02,98,0,0,115.30999999999999,0.0,98
18030,2011-10-28,2011-12-05,42,1,38,230.64999999999995,38.0,4
18032,2011-01-09,2011-01-09,334,0,0,73.5,0.0,334
18033,2011-10-05,2011-10-05,65,0,0,97.97000000000004,0.0,65
18034,2011-11-18,2011-11-18,21,0,0,422.8800000000001,0.0,21
18035,2011-10-27,2011-11-04,43,1,8,730.4000000000001,8.0,35
18036,2011-04-08,2011-11-07,245,2,213,405.6199999999999,106.0,32
18037,2010-12-12,2011-07-08,362,5,208,70.02,42.0,154
18040,2011-04-08,2011-11-20,245,1,226,357.2000000000001,226.0,19
18041,2010-12-02,2011-11-28,372,19,361,4183.389999999996,19.0,11
18042,2011-10-17,2011-10-17,53,0,0,165.04999999999995,0.0,53
18043,2010-12-08,2011-11-15,366,2,342,559.5099999999996,171.0,24
18044,2010-12-14,2011-12-05,360,9,356,2088.599999999999,40.0,4
18045,2011-10-25,2011-10-25,45,0,0,189.39999999999995,0.0,45
18048,2011-05-20,2011-05-20,203,0,0,172.29000000000002,0.0,203
18050,2010-12-15,2010-12-15,359,0,0,74.4,0.0,359
18053,2011-09-30,2011-09-30,70,0,0,300.02000000000004,0.0,70
18055,2010-12-05,2011-12-02,369,9,362,6784.1900000000005,40.0,7
18056,2011-02-24,2011-02-24,288,0,0,363.65,0.0,288
18058,2011-11-30,2011-11-30,9,0,0,170.16,0.0,9
18059,2011-10-03,2011-11-16,67,2,44,306.46,22.0,23
18061,2010-12-08,2011-11-18,366,9,345,2119.4099999999994,38.0,21
18062,2011-01-06,2011-06-19,337,2,164,720.5200000000001,82.0,173
18064,2011-04-18,2011-07-29,235,1,102,814.0,102.0,133
18065,2010-12-10,2011-12-04,364,5,359,2392.830000000001,72.0,5
18066,2011-09-25,2011-09-25,75,0,0,318.0,0.0,75
18067,2011-10-30,2011-10-30,40,0,0,396.33000000000015,0.0,40
18068,2011-02-23,2011-02-23,289,0,0,101.7,0.0,289
18069,2011-01-16,2011-11-13,327,4,301,2036.6700000000003,75.0,26
18071,2010-12-09,2011-03-27,365,1,108,453.0,108.0,257
18072,2011-06-07,2011-06-07,185,0,0,247.44,0.0,185
18073,2011-05-26,2011-08-17,197,9,83,3877.520000000002,9.0,114
18074,2010-12-01,2010-12-01,373,0,0,489.6,0.0,373
18075,2010-12-14,2011-11-16,360,9,337,2611.750000000001,37.0,23
18077,2010-12-08,2011-12-01,366,10,358,2633.0099999999984,36.0,8
18078,2011-03-25,2011-05-06,259,1,42,336.13,42.0,217
18079,2011-04-15,2011-10-25,238,2,193,3651.969999999997,96.0,45
18080,2011-04-11,2011-11-21,242,1,224,1231.5,224.0,18
18081,2011-07-29,2011-11-03,133,2,97,343.45,48.0,36
18082,2011-11-14,2011-11-14,25,0,0,703.3699999999997,0.0,25
18084,2011-11-23,2011-11-23,16,0,0,90.48,0.0,16
18085,2010-12-01,2011-01-13,373,1,43,689.95,43.0,330
18086,2011-03-10,2011-03-10,274,0,0,101.33999999999999,0.0,274
18087,2011-02-22,2011-09-02,290,1,192,4055.7200000000003,192.0,98
18088,2011-10-09,2011-10-09,61,0,0,167.67,0.0,61
18092,2010-12-09,2011-12-07,365,9,363,9068.260000000002,40.0,2
18093,2011-02-10,2011-09-07,302,3,209,2106.52,70.0,93
18094,2011-02-21,2011-09-19,291,4,210,3017.2999999999993,52.0,81
18095,2011-01-11,2011-01-31,332,1,20,580.05,20.0,312
18096,2011-10-07,2011-11-28,63,2,52,911.1500000000001,26.0,11
18097,2010-12-20,2011-12-02,354,4,347,2697.7999999999997,87.0,7
18099,2011-08-04,2011-08-04,127,0,0,168.31000000000003,0.0,127
18101,2011-07-19,2011-11-28,143,1,132,223.65,132.0,11
18102,2010-12-07,2011-12-09,367,25,367,259657.30000000005,15.0,0
18104,2011-11-02,2011-11-02,37,0,0,754.6400000000002,0.0,37
18105,2011-11-02,2011-11-02,37,0,0,113.48000000000002,0.0,37
18106,2011-01-14,2011-01-14,329,0,0,430.6999999999999,0.0,329
18108,2011-03-30,2011-03-30,254,0,0,271.0,0.0,254
18109,2010-12-05,2011-12-08,369,24,368,8052.969999999997,15.0,1
18110,2011-11-20,2011-11-20,19,0,0,236.3,0.0,19
18112,2011-06-26,2011-11-27,166,1,154,352.69,154.0,12
18113,2010-12-06,2010-12-06,368,0,0,76.32000000000002,0.0,368
18114,2011-02-22,2011-02-22,290,0,0,220.1,0.0,290
18116,2010-12-10,2011-10-03,364,7,297,1418.0300000000016,42.0,67
18117,2011-11-14,2011-11-14,25,0,0,320.71999999999997,0.0,25
18118,2010-12-05,2011-11-29,369,25,359,5653.819999999971,14.0,10
18119,2010-12-07,2010-12-07,367,0,0,181.11999999999998,0.0,367
18120,2011-05-09,2011-05-09,214,0,0,111.14999999999999,0.0,214
18121,2011-07-08,2011-07-13,154,1,5,673.1000000000003,5.0,149
18122,2011-07-12,2011-12-01,150,5,142,1826.2100000000016,28.0,8
18123,2011-11-08,2011-11-15,31,1,7,589.44,7.0,24
18125,2011-01-27,2011-11-10,316,3,287,1142.989999999999,96.0,29
18126,2011-10-10,2011-10-10,60,0,0,206.83000000000007,0.0,60
18127,2011-07-29,2011-11-20,133,1,114,348.7299999999999,114.0,19
18129,2011-04-10,2011-04-10,243,0,0,112.55,0.0,243
18130,2011-10-13,2011-11-24,57,2,42,1059.3900000000003,21.0,15
18133,2011-05-11,2011-05-11,212,0,0,931.5,0.0,212
18135,2011-06-02,2011-11-10,190,4,161,681.9100000000001,40.0,29
18136,2011-01-24,2011-10-07,319,2,256,784.3299999999999,128.0,63
18138,2011-02-17,2011-02-17,295,0,0,152.65,0.0,295
18139,2011-11-21,2011-11-22,18,1,1,8438.339999999997,1.0,17
18142,2011-05-08,2011-07-05,215,1,58,1019.5199999999999,58.0,157
18143,2011-07-21,2011-08-15,141,1,25,1000.1599999999997,25.0,116
18144,2010-12-01,2011-12-02,373,10,366,2888.7500000000005,37.0,7
18145,2011-01-31,2011-11-27,312,3,300,2861.5500000000006,100.0,12
18146,2011-05-03,2011-07-22,220,1,80,160.35,80.0,140
18147,2011-08-23,2011-10-25,108,1,63,179.33999999999997,63.0,45
18149,2011-03-11,2011-10-20,273,2,223,612.08,112.0,50
18150,2011-05-22,2011-11-07,201,2,169,566.5800000000002,84.0,32
18151,2011-02-23,2011-07-28,289,1,155,653.3499999999999,155.0,134
18154,2011-10-27,2011-12-06,43,1,40,399.19,40.0,3
18155,2011-02-21,2011-09-25,291,2,216,371.62000000000006,108.0,75
18156,2010-12-05,2011-11-27,369,1,357,734.94,357.0,12
18158,2011-09-12,2011-11-30,88,1,79,453.4000000000001,79.0,9
18159,2011-02-11,2011-02-11,301,0,0,530.1500000000003,0.0,301
18160,2011-05-23,2011-10-13,200,1,143,638.0600000000002,143.0,57
18161,2011-01-24,2011-11-24,319,4,304,1618.6899999999998,76.0,15
18164,2011-11-02,2011-11-02,37,0,0,399.65000000000003,0.0,37
18165,2011-06-15,2011-06-15,177,0,0,302.46000000000004,0.0,177
18167,2011-08-26,2011-11-16,105,2,82,1384.86,41.0,23
18168,2010-12-02,2011-06-16,372,5,196,1169.94,39.0,176
18169,2011-10-10,2011-10-10,60,0,0,202.65000000000003,0.0,60
18170,2011-05-06,2011-11-06,217,2,184,980.3100000000002,92.0,33
18171,2011-01-10,2011-10-12,333,4,275,1231.3099999999997,69.0,58
18172,2011-02-23,2011-11-25,289,13,275,7561.68,21.0,14
18173,2011-03-10,2011-09-14,274,3,188,2106.84,63.0,86
18174,2011-12-02,2011-12-02,7,0,0,104.0,0.0,7
18176,2010-12-16,2010-12-16,358,0,0,476.34999999999997,0.0,358
18177,2011-03-29,2011-11-08,255,5,224,1341.4199999999994,45.0,31
18178,2010-12-10,2011-08-03,364,3,236,1590.8099999999997,79.0,128
18179,2011-01-07,2011-11-30,336,5,327,1793.1700000000008,65.0,9
18180,2011-07-20,2011-12-05,142,5,138,1843.75,28.0,4
18181,2011-11-15,2011-11-15,24,0,0,382.79999999999995,0.0,24
18183,2011-03-10,2011-04-26,274,1,47,632.07,47.0,227
18184,2011-11-24,2011-11-24,15,0,0,49.8,0.0,15
18185,2011-04-04,2011-04-04,249,0,0,304.25,0.0,249
18188,2011-02-22,2011-11-24,290,2,275,2001.04,138.0,15
18189,2011-03-17,2011-09-23,267,1,190,1090.24,190.0,77
18190,2011-01-13,2011-05-31,330,1,138,284.46000000000004,138.0,192
18191,2011-03-23,2011-03-23,261,0,0,207.8,0.0,261
18192,2011-09-29,2011-09-29,71,0,0,957.9699999999999,0.0,71
18193,2011-06-27,2011-06-27,165,0,0,243.76000000000005,0.0,165
18194,2011-09-18,2011-09-18,82,0,0,973.8399999999999,0.0,82
18196,2011-02-22,2011-09-05,290,1,195,689.1300000000003,195.0,95
18198,2011-01-07,2011-12-05,336,16,332,5425.560000000004,21.0,4
18200,2011-08-25,2011-08-25,106,0,0,163.8,0.0,106
18202,2011-02-01,2011-05-24,311,1,112,1396.9900000000007,112.0,199
18203,2011-07-05,2011-07-05,157,0,0,160.42000000000002,0.0,157
18204,2011-05-31,2011-09-29,192,2,121,1993.7,60.0,71
18205,2011-09-26,2011-11-03,74,1,38,517.36,38.0,36
18209,2011-11-11,2011-11-11,28,0,0,139.10000000000002,0.0,28
18210,2011-03-17,2011-12-08,267,5,266,2621.379999999999,53.0,1
18211,2011-03-06,2011-11-14,278,4,253,600.07,63.0,25
18212,2011-01-17,2011-01-17,326,0,0,248.41999999999993,0.0,326
18213,2011-04-17,2011-04-17,236,0,0,232.48000000000005,0.0,236
18215,2011-09-11,2011-09-11,89,0,0,299.34000000000003,0.0,89
18216,2011-11-08,2011-11-08,31,0,0,481.75000000000006,0.0,31
18217,2011-09-30,2011-11-10,70,1,41,621.75,41.0,29
18218,2011-03-03,2011-05-12,281,1,70,662.08,70.0,211
18219,2010-12-06,2011-12-07,368,8,366,2069.7700000000004,46.0,2
18220,2011-04-27,2011-04-27,226,0,0,305.28,0.0,226
18221,2011-05-12,2011-11-17,211,4,189,1041.6100000000001,47.0,22
18222,2011-09-08,2011-09-08,92,0,0,443.0,0.0,92
18223,2010-12-16,2011-12-05,358,12,354,6484.540000000004,30.0,4
18224,2011-03-21,2011-03-21,263,0,0,158.95000000000002,0.0,263
18225,2010-12-09,2011-12-06,365,11,362,5509.12,33.0,3
18226,2011-01-06,2011-10-26,337,10,293,5228.050000000004,29.0,44
18227,2011-05-06,2011-05-06,217,0,0,93.75,0.0,217
18228,2011-09-21,2011-10-14,79,1,23,779.9000000000001,23.0,56
18229,2010-12-01,2011-11-28,373,19,362,7276.900000000001,19.0,11
18230,2011-02-10,2011-11-30,302,6,293,2810.199999999999,49.0,9
18231,2011-02-24,2011-05-31,288,4,96,2083.2700000000013,24.0,192
18232,2011-05-26,2011-09-19,197,3,116,592.97,39.0,81
18233,2011-01-18,2011-01-18,325,0,0,440.0,0.0,325
18235,2011-05-06,2011-09-29,217,2,146,1796.48,73.0,71
18236,2011-04-13,2011-11-10,240,5,211,882.24,42.0,29
18237,2011-07-28,2011-12-07,134,4,132,987.0999999999998,33.0,2
18239,2010-12-02,2011-05-05,372,4,154,1561.6099999999997,38.0,218
18240,2011-10-24,2011-10-24,46,0,0,422.58000000000004,0.0,46
18241,2011-05-06,2011-11-30,217,16,208,2073.090000000001,13.0,9
18242,2011-05-10,2011-09-28,213,2,141,2232.49,70.0,72
18245,2010-12-19,2011-12-02,355,4,348,2567.0599999999995,87.0,7
18246,2011-04-20,2011-11-16,233,1,210,596.0999999999999,210.0,23
18248,2011-06-06,2011-08-09,186,1,64,804.02,64.0,122
18249,2011-11-22,2011-11-22,17,0,0,95.34,0.0,17
18250,2011-02-02,2011-02-02,310,0,0,349.2700000000001,0.0,310
18251,2011-09-13,2011-09-13,87,0,0,4314.719999999999,0.0,87
18252,2011-06-21,2011-10-20,171,1,121,526.6699999999996,121.0,50
18255,2011-09-11,2011-09-11,89,0,0,103.3,0.0,89
18257,2011-02-16,2011-10-31,296,6,257,2337.6300000000006,43.0,39
18259,2010-12-08,2011-11-15,366,2,342,2338.6000000000004,171.0,24
18260,2010-12-16,2011-06-20,358,5,186,2643.2000000000003,37.0,172
18261,2011-09-05,2011-10-27,95,1,52,324.24,52.0,43
18262,2011-07-22,2011-07-22,140,0,0,149.48,0.0,140
18263,2011-04-01,2011-11-14,252,2,227,1213.16,114.0,25
18265,2011-07-04,2011-09-28,158,1,86,801.5100000000001,86.0,72
18268,2011-07-28,2011-07-28,134,0,0,25.5,0.0,134
18269,2010-12-08,2010-12-08,366,0,0,168.6,0.0,366
18270,2011-03-18,2011-11-01,266,1,228,283.15000000000003,228.0,38
18272,2011-04-07,2011-12-07,246,5,244,3078.5800000000004,49.0,2
18273,2011-03-27,2011-12-07,257,2,255,204.0,128.0,2
18274,2011-11-09,2011-11-09,30,0,0,175.92,0.0,30
18276,2011-10-27,2011-10-27,43,0,0,335.8599999999999,0.0,43
18277,2011-10-12,2011-10-12,58,0,0,110.38,0.0,58
18278,2011-09-27,2011-09-27,73,0,0,173.9,0.0,73
18280,2011-03-07,2011-03-07,277,0,0,180.6,0.0,277
18281,2011-06-12,2011-06-12,180,0,0,80.82,0.0,180
18282,2011-08-05,2011-12-02,126,1,119,178.05,119.0,7
18283,2011-01-06,2011-12-06,337,13,334,2094.880000000003,26.0,3
18287,2011-05-22,2011-10-28,201,2,159,1837.2799999999997,80.0,42
